tsáiɁ¹²	V;IPFV;2;PST	mi³-huaiɁ¹²	mi³-tsaiɁ²
kø²+káng¹²	V;IPFV;2;PST	mi³-kø²+kang¹²	mi³-kø²+kang
guiágɁ¹²	V;IPFV;2;PST	mi³-guiagɁ¹²	mi³-guiagɁ¹
bø²+hmé²	V;IPFV;2;PST	mi³-bø²+hme²	mi³-bø²+hme
ɁnóɁ¹² dsí²	V;IPFV;2;PST	mi³-ɁnoɁ¹²	mi³-ɁnoɁ¹²¹g²
dsánɁ¹²	V;IPFV;2;PST	mi³-dsanɁ¹²	mi³-dsanɁ¹
Ɂuø¹²	V;IPFV;2;PST	mi³-Ɂuø³	mi³-Ɂuø²¹
guión²	V;IPFV;2;PST	mi³-guion³	mi³-guion³
lǿɁ²	V;IPFV;2;PST	mi³-lēɁ²	mi³-løɁ¹²
tií²	V;IPFV;2;PST	mi³-tii¹²	mi³-tii¹²
héinɁ¹²	V;IPFV;2;PST	mi³-heinɁ³	mi³-heinɁ¹
hénɁ²	V;IPFV;2;PST	mi³-henɁ³	mi³-henɁ¹
hǿɁ¹²	V;IPFV;2;PST	mi³-tsøɁ²	mi³-høɁ¹²
chi²+dsán²	V;IPFV;2;PST	mi³-chi²+dsan²	mi³-chi²+dsa
mi²+dsøg¹²	V;IPFV;2;PST	mi³-mi²+dsøg¹³	mi³-mi²+dsøg
guieɁ¹²	V;IPFV;2;PST	mi³-guieɁ²	mi³-guieɁ²
mi²+chian¹²	V;IPFV;2;PST	mi³-mi²+chian³	mi³-mi²+chian
guiúg²	V;IPFV;2;PST	mi³-guiug¹²	mi³-guiug¹
Ɂon¹²	V;IPFV;2;PST	mi³-Ɂøng²	mi³-Ɂon¹²
tangɁ²	V;IPFV;2;PST	mi³-tangɁ²	mi³-tangɁ²
Ɂan¹²	V;IPFV;2;PST	mi³-Ɂan¹²	mi³-Ɂan¹²
dsian¹²	V;IPFV;2;PST	mi³-dsian¹²	mi³-dsian¹
dság¹²	V;IPFV;2;PST	mi³-gogɁ²	mi³-dsag²¹
chi²+dsí²	V;IPFV;2;PST	mi³-chi²+dsi³	mi³-chi²+dsi
tsanɁ¹²	V;IPFV;2;PST	mi³-huanɁ³	mi³-tsanɁ¹
tánɁ¹²	V;IPFV;2;PST	mi³-tanɁ¹²	mi³-tanɁ¹²
kuøin¹²	V;IPFV;2;PST	mi³-kuøin¹²	mi³-kuøin¹
gógɁ¹²	V;IPFV;2;PST	mi³-gogɁ¹²	mi³-gogɁ³²
tsø²+nióɁ¹²	V;IPFV;2;PST	mi³-tsø²+nioɁ¹	mi³-tsø²+nioɁ
mi²+hénɁ²	V;IPFV;2;PST	mi³-mi²+henɁ³	mi³-mi²+henɁ
ti²+líɁ¹	V;IPFV;2;PST	mi³-ti²+leɁ¹	mi³-ti²+leɁ
hánɁ¹²	V;IPFV;2;PST	mi³-hanɁ¹²	mi³-hanɁ¹²
ɁúgɁ²	V;IPFV;2;PST	mi³-ɁogɁ³	mi³-ɁugɁ³
hiúg²	V;IPFV;2;PST	mi³-hiug³	mi³-hiug²
chio¹²	V;IPFV;2;PST	mi³-chieg²	mi³-chio¹²
hinɁ³	V;IPFV;2;PST	mi³-hinɁ³	mi³-hinɁ³
tian¹²	V;IPFV;2;PST	mi³-tian¹²	mi³-tian¹²
mi²+hmḗ²	V;IPFV;2;PST	mi³-mi²+hmē³	mi³-mi²+hmē
ngē¹²	V;IPFV;2;PST	mi³-ngē¹³	mi³-ngē²²
lanɁ¹²	V;IPFV;2;PST	mi³-lanɁ¹²	mi³-lanɁ²²
ngái¹²	V;IPFV;2;PST	mi³-ngai³	mi³-ngai³²
tión²	V;IPFV;2;PST	mi³-ton³	mi³-tion¹
Ɂøa¹²	V;IPFV;2;PST	mi³-Ɂøa²	mi³-Ɂøa²²
hngiáɁ²	V;IPFV;2;PST	mi³-hngiaɁ²	mi³-hngiaɁ
ngioɁ¹²	V;IPFV;2;PST	mi³-ngioɁ²	mi³-ngioɁ²
ngøa¹²	V;IPFV;2;PST	mi³-ngøa²	mi³-ngøa²³
ɁlianɁ²	V;IPFV;2;PST	mi³-ɁlianɁ²	mi³-ɁlianɁ
hngióɁ¹²	V;IPFV;2;PST	mi³-hngioɁ¹³	mi³-hngioɁ¹
se¹²	V;IPFV;2;PST	mi³-se¹²	mi³-se²³³
tsǿɁ¹²	V;IPFV;2;PST	mi³-tsøɁ¹²	mi³-tsøɁ¹²
ta¹²	V;IPFV;2;PST	mi³-ta²	mi³-ta²³²
ha²+Ɂan³	V;IPFV;2;PST	mi³-ha²+Ɂan³	mi³-ha²+Ɂan
kúgɁ¹²	V;IPFV;2;PST	mi³-kugɁ¹²	mi³-kugɁ³²
huúɁ¹²	V;IPFV;2;PST	mi³-huuɁ³	mi³-huuɁ³³
kágɁ¹²	V;IPFV;2;PST	mi³-kagɁ³	mi³-kagɁ¹²
guái²	V;IPFV;2;PST	mi³-guai¹²	mi³-guai¹
hḗnɁ²	V;IPFV;2;PST	mi³-hēnɁ¹³	mi³-hēnɁ¹
chi²+kián²	V;IPFV;2;PST	mi³-chi²+kian³	mi³-chi²+kia
hian¹²	V;IPFV;2;PST	mi³-han¹²	mi³-hian¹³
téiɁ¹²	V;IPFV;2;PST	mi³-teiɁ²	mi³-teiɁ¹²
lóɁ¹²	V;IPFV;2;PST	mi³-loɁ²	mi³-loɁ²Ɂ
tsog¹²	V;IPFV;2;PST	mi³-tsog¹³	mi³-tsog²²
ɁóɁ²	V;IPFV;2;PST	mi³-ɁoɁ¹²	mi³-ɁoɁ²²
ngē²	V;IPFV;2;PST	mi³-ngē²	mi³-ngē¹²
mi²+dsēn¹²	V;IPFV;2;PST	mi³-mi²+dsēn¹³	mi³-mi²+dsēn
mi²+ɁḗɁ²	V;IPFV;2;PST	mi³-mi²+ɁēɁ³	mi³-mi²+ɁēɁ
uénɁ²	V;IPFV;2;PST	mi³-uenɁ²	mi³-uenɁ²
rón²	V;IPFV;2;PST	mi³-ron³	mi³-ron³³
hǿɁ²	V;IPFV;2;PST	mi³-høɁ¹²	mi³-høɁ¹²
hnǿ²	V;IPFV;2;PST	mi³-hnø¹²	mi³-hnø¹¹
tai²	V;IPFV;2;PST	mi³-tai³	mi³-tai²²
mi²+tan¹³	V;IPFV;2;PST	mi³-mi²+tan¹³	mi³-mi²+tan¹
ɁuǿɁ¹²	V;IPFV;2;PST	mi³-ɁuøɁ¹³	mi³-ɁuøɁ¹²
kán²	V;IPFV;2;PST	mi³-kan²	mi³-kan²²
dsø²+huen¹³	V;IPFV;2;PST	mi³-dsø²+huen¹³	mi³-dsø²+huen
lag²	V;IPFV;2;PST	mi³-lag¹²	mi³-lag¹²
kiúgɁ²	V;IPFV;2;PST	mi³-kiugɁ³	mi³-kiugɁ³
huú²	V;IPFV;2;PST	mi³-huø¹²	mi³-huu¹³
mi²+Ɂnio¹	V;IPFV;2;PST	mi³-mi²+Ɂnio¹	mi³-mi²+Ɂnio
bán²	V;IPFV;2;PST	mi³-ban¹²	mi³-ban¹²
kiuɁ¹²	V;IPFV;2;PST	mi³-kiuɁ²	mi³-kiuɁ²³
guøn¹²	V;IPFV;2;PST	mi³-guøn¹²	mi³-guøn¹²
len¹²	V;IPFV;2;PST	mi³-len¹²	mi³-len²²
rǿnɁ¹²	V;IPFV;2;PST	mi³-rønɁ³	mi³-rønɁ³²
gog²	V;IPFV;2;PST	mi³-gog¹²	mi³-gog¹²
lán¹²	V;IPFV;2;PST	mi³-lan¹²	mi³-lan²¹
niá²	V;IPFV;2;PST	mi³-na³	mi³-nia¹²
Ɂno¹²	V;IPFV;2;PST	mi³-Ɂnøng²	mi³-Ɂno²²
ngiéɁ¹²	V;IPFV;2;PST	mi³-ngieɁ³	mi³-ngieɁ¹
siúg²	V;IPFV;2;PST	mi³-siug³	mi³-siug³
teng¹²	V;IPFV;2;PST	mi³-tøng²	mi³-teng²²
mi²+kon¹²	V;IPFV;2;PST	mi³-mi²+kon³	mi³-mi²+kon³
ngié²	V;IPFV;2;PST	mi³-ngie²	mi³-ngie²
tsogɁ² hmøi²	V;IPFV;2;PST	mi³-tsogɁ²	mi³-tsogɁ²²Ɂ³²
ɁnáiɁ¹²	V;IPFV;2;PST	mi³-ɁnaiɁ²	mi³-ɁnaiɁ²
hnio³	V;IPFV;2;PST	mi³-hnio³	mi³-hnio³
ténɁ¹²	V;IPFV;2;PST	mi³-tenɁ³	mi³-tenɁ²²
guǿn¹²	V;IPFV;2;PST	mi³-guøn¹²	mi³-guøn¹²
tson²	V;IPFV;2;PST	mi³-tson²	mi³-tson²
Ɂio¹²	V;IPFV;2;PST	mi³-Ɂøg²	mi³-Ɂio²²
hen¹²	V;IPFV;2;PST	mi³-hen¹²	mi³-hen²²
hián²	V;IPFV;2;PST	mi³-hian¹²	mi³-hian¹
huǿin¹²	V;IPFV;2;PST	mi³-huøin²	mi³-huøin¹
tsón¹²	V;IPFV;2;PST	mi³-tson¹²	mi³-tson¹²
kii²+túg²	V;IPFV;2;PST	mi³-kii²+tog³	mi³-kii²+tog
kii²+tág¹²	V;IPFV;2;PST	mi³-kii²+tag²	mi³-kii²+tag
hngia¹²	V;IPFV;2;PST	mi³-han¹³	mi³-han¹³³
dsoɁ²	V;IPFV;2;PST	mi³-dsoɁ²	mi³-dsoɁ²
Ɂán²	V;IPFV;2;PST	mi³-Ɂan²	mi³-Ɂan¹²
køn¹²	V;IPFV;2;PST	mi³-køn²	mi³-køn²¹
tsog²	V;IPFV;2;PST	mi³-tsog²	mi³-tsog²
mi²+tsḗn¹	V;IPFV;2;PST	mi³-mi²+tsēn¹³	mi³-mi²+tsēn
tsǿaɁ¹²	V;IPFV;2;PST	mi³-tsøaɁ²	mi³-tsøaɁ²
hne¹²	V;IPFV;2;PST	mi³-hnøa²	mi³-hne²²
ɁioɁ¹²	V;IPFV;2;PST	mi³-ɁianɁ¹²	mi³-ɁioɁ¹²
ku²+hmáɁ²	V;IPFV;2;PST	mi³-ku²+hmaɁ¹²	mi³-ku²+hmaɁ
hngie¹²	V;IPFV;2;PST	mi³-han³	mi³-han³e³
nēɁ¹²	V;IPFV;2;PST	mi³-nēɁ¹²	mi³-nēɁ³²
húɁ²	V;IPFV;2;PST	mi³-huɁ²	mi³-huɁ¹²
mi²+dsiog¹	V;IPFV;2;PST	mi³-mi²+dsiog¹	mi³-mi²+dsio
Ɂnia¹²	V;IPFV;2;PST	mi³-Ɂnia¹³	mi³-Ɂnia¹²
héin¹²	V;IPFV;2;PST	mi³-hein³	mi³-hein¹²
dsiánɁ¹²	V;IPFV;2;PST	mi³-dsianɁ¹²	mi³-dsianɁ¹
kieg²	V;IPFV;2;PST	mi³-køg¹²	mi³-kieg²
mi²+tan¹²	V;IPFV;2;PST	mi³-mi²+tan³	mi³-mi²+tan³
køin²	V;IPFV;2;PST	mi³-køin¹²	mi³-køin¹
ɁēnɁ¹²	V;IPFV;2;PST	mi³-ɁēnɁ²	mi³-ɁēnɁ²²
kióɁ¹²	V;IPFV;2;PST	mi³-kioɁ³	mi³-kioɁ¹³
Ɂlúg²	V;IPFV;2;PST	mi³-Ɂlug²	mi³-Ɂlug²
møa¹²	V;IPFV;2;PST	mi³-møa²	mi³-møa²²
gǿaɁ¹²	V;IPFV;2;PST	mi³-køgɁ²	mi³-gøaɁ²²
guen²	V;IPFV;2;PST	mi³-guen²	mi³-guen²
hngēɁ¹²	V;IPFV;2;PST	mi³-hngēɁ²	mi³-hngēɁ²
dsie¹²	V;IPFV;2;PST	mi³-dsie²	mi³-dsie²²
tsénɁ²	V;IPFV;2;PST	mi³-tsēnɁ²	mi³-tsenɁ²
chiunɁ¹²	V;IPFV;2;PST	mi³-chiunɁ²	mi³-chiunɁ²
Ɂméi¹²	V;IPFV;2;PST	mi³-Ɂmei³	mi³-Ɂmei³²
tø²+húg³	V;IPFV;2;PST	mi³-tø²+hug³	mi³-tø²+hug
kug²	V;IPFV;2;PST	mi³-kug²	mi³-kug²³
tsēn¹²	V;IPFV;2;PST	mi³-tsēn²	mi³-tsēn²²
mi²+Ɂlí¹	V;IPFV;2;PST	mi³-mi²+Ɂli³	mi³-mi²+Ɂli
dsen³ (kaɁ³)	V;IPFV;2;PST	mi³-dsen³	mi³-dsen³¹²¹³³
chiogɁ¹²	V;IPFV;2;PST	mi³-chiogɁ¹²	mi³-chiogɁ¹
chi²+méɁ²	V;IPFV;2;PST	mi³-chi²+meɁ¹²	mi³-chi²+meɁ
Ɂén²	V;IPFV;2;PST	mi³-Ɂen¹²	mi³-Ɂen¹²
hánɁ²	V;IPFV;2;PST	mi³-hanɁ¹²	mi³-hanɁ¹
tsø²+kuønɁ¹²	V;IPFV;2;PST	mi³-tsø²+kuønɁ¹²	mi³-tsø²+kuønɁ
uǿi²	V;IPFV;2;PST	mi³-uøi²	mi³-uøi²²
mi²+kuuɁ¹²	V;IPFV;2;PST	mi³-mi²+kuuɁ¹³	mi³-mi²+kuuɁ
mi²+hlíɁ²	V;IPFV;2;PST	mi³-mi²+hliɁ³	mi³-mi²+hliɁ
mi²+níɁ¹	V;IPFV;2;PST	mi³-mi²+niɁ³	mi³-mi²+niɁ
búɁ²	V;IPFV;2;PST	mi³-buɁ¹²	mi³-buɁ¹²
køɁ³ (hmai³)	V;IPFV;2;PST	mi³-kēɁ³	mi³-kēɁ³³gi³²³
Ɂiei¹²	V;IPFV;2;PST	mi³-Ɂiei²	mi³-Ɂiei²²
niuɁ³	V;IPFV;2;PST	mi³-niuɁ³	mi³-niuɁ³
hngiángɁ¹²	V;IPFV;2;PST	mi³-hngiangɁ³	mi³-hngiangɁ
tsø²+han¹²	V;IPFV;2;PST	mi³-tsø²+han¹²	mi³-tsø²+han
kién¹²	V;IPFV;2;PST	mi³-kien¹³	mi³-kien¹³
hḗn²	V;IPFV;2;PST	mi³-hēn¹²	mi³-hēn¹²
ngai¹²	V;IPFV;2;PST	mi³-ngai³	mi³-ngai³²
chión²	V;IPFV;2;PST	mi³-chion³	mi³-chion³
guianɁ¹²	V;IPFV;2;PST	mi³-guianɁ²	mi³-guianɁ¹
hmḗɁ²	V;IPFV;2;PST	mi³-hmēɁ³	mi³-hmēɁ³
Ɂiog¹²	V;IPFV;2;PST	mi³-Ɂog¹²	mi³-Ɂigg²²
dsø²+togɁ¹²	V;IPFV;2;PST	mi³-dsø²+togɁ¹²	mi³-dsø²+togɁ
dsiég¹²	V;IPFV;2;PST	mi³-dsieg¹²	mi³-dsieg¹
mi²+dsíg²	V;IPFV;2;PST	mi³-mi²+dsig³	mi³-mi²+dsig
tǿɁ²	V;IPFV;2;PST	mi³-tøa¹²	mi³-tøɁ¹²
huúɁ²	V;IPFV;2;PST	mi³-huuɁ²	mi³-huuɁ³
ɁiéiɁ¹²	V;IPFV;2;PST	mi³-ɁieiɁ²	mi³-ɁieiɁ²
ti²+dsǿ²	V;IPFV;2;PST	mi³-ti²+dsø³	mi³-ti²+dsø
chiag¹²	V;IPFV;2;PST	mi³-chiag²	mi³-chiag¹
káiɁ¹²	V;IPFV;2;PST	mi³-kaiɁ²	mi³-kaiɁ¹²
guen¹²	V;IPFV;2;PST	mi³-guen³	mi³-guen²²
mi²+hǿ²	V;IPFV;2;PST	mi³-mi²+hø³	mi³-mi²+hø
hmáɁ² (dsǿa¹²)	V;IPFV;2;PST	mi³-hmaɁ¹³	mi³-hmaɁ¹³¹³¹²³
tónɁ² (huu¹²)	V;IPFV;2;PST	mi³-tonɁ²	mi³-tonɁ²²¹¹³²
tanɁ²	V;IPFV;2;PST	mi³-tanɁ²	mi³-tanɁ²
mi²+kánɁ²	V;IPFV;2;PST	mi³-mi²+kanɁ³	mi³-mi²+kanɁ
Ɂuan¹²	V;IPFV;2;PST	mi³-Ɂuan¹³	mi³-Ɂuan¹³
Ɂúg²	V;IPFV;2;PST	mi³-Ɂug¹²	mi³-Ɂug¹²
kēnɁ¹²	V;IPFV;2;PST	mi³-kēnɁ²	mi³-kēnɁ²²
dsióɁ¹²	V;IPFV;2;PST	mi³-dsioɁ¹²	mi³-dsioɁ¹
kiéɁ¹²	V;IPFV;2;PST	mi³-kieɁ³	mi³-kieɁ¹³
bén²	V;IPFV;2;PST	mi³-ben¹²	mi³-ben¹²
hlái²	V;IPFV;2;PST	mi³-hlai¹²	mi³-hlai¹
héɁ²	V;IPFV;2;PST	mi³-heɁ³	mi³-heɁ¹²
ɁnióɁ¹²	V;IPFV;2;PST	mi³-ɁnioɁ¹²	mi³-ɁnioɁ³
tag¹²	V;IPFV;2;PST	mi³-tøg²	mi³-tag²²
ɁiánɁ²	V;IPFV;2;PST	mi³-ɁianɁ¹²	mi³-ɁianɁ²
mi²+Ɂai¹	V;IPFV;2;PST	mi³-mi²+Ɂai¹	mi³-mi²+Ɂai
kiog¹²	V;IPFV;2;PST	mi³-kog²	mi³-kiog¹³
dsan²	V;IPFV;2;PST	mi³-dsan²	mi³-dsan²
ɁónɁ²	V;IPFV;2;PST	mi³-ɁonɁ³	mi³-ɁonɁ¹
hmáɁ² (ta³)	V;IPFV;2;PST	mi³-hmaɁ¹³	mi³-hmaɁ¹³³³²
tiun¹²	V;IPFV;2;PST	mi³-tøng¹²	mi³-tiun²²
ha¹²	V;IPFV;2;PST	mi³-ha¹³	mi³-ha²³²
guian¹²	V;IPFV;2;PST	mi³-guian¹³	mi³-guian¹
ti²+li¹	V;IPFV;2;PST	mi³-ti²+li³	mi³-ti²+li
mi²+ngḗɁ¹	V;IPFV;2;PST	mi³-mi²+ngēɁ³	mi³-mi²+ngēɁ
Ɂien²	V;IPFV;2;PST	mi³-Ɂien²	mi³-Ɂien²
guiúnɁ¹²	V;IPFV;2;PST	mi³-guiunɁ¹²	mi³-guiunɁ¹
hngiíɁ²	V;IPFV;2;PST	mi³-hngieɁ¹²	mi³-hngieɁ
Ɂmǿi²	V;IPFV;2;PST	mi³-Ɂmai¹²	mi³-Ɂmai¹
hnó²	V;IPFV;2;PST	mi³-hno³	mi³-hno¹²
Ɂngieng¹²	V;IPFV;2;PST	mi³-Ɂngieng²	mi³-Ɂngieng²
dsii²+lian¹	V;IPFV;2;PST	mi³-dsii²+lian¹	mi³-dsii²+lia
hné¹²	V;IPFV;2;PST	mi³-hnē³	mi³-hne²³
tsón²	V;IPFV;2;PST	mi³-tson³	mi³-tson¹
chiog¹²	V;IPFV;2;PST	mi³-chiog¹²	mi³-chiog¹
kiáɁ²	V;IPFV;2;PST	mi³-kiaɁ¹³	mi³-kiaɁ¹
mi²+rø¹²	V;IPFV;2;PST	mi³-mi²+rø³	mi³-mi²+rø³
kií¹²	V;IPFV;2;PST	mi³-kø²	mi³-kii¹²
kian¹²	V;IPFV;2;PST	mi³-kian¹³	mi³-kian¹³
mi²+hínɁ²	V;IPFV;2;PST	mi³-mi²+hinɁ³	mi³-mi²+hinɁ
Ɂngiéng¹²	V;IPFV;2;PST	mi³-Ɂngieng²	mi³-Ɂngieng²
tián²	V;IPFV;2;PST	mi³-tian¹²	mi³-tian¹
ɁnáɁ¹²	V;IPFV;2;PST	mi³-ɁnaɁ¹²	mi³-ɁnaɁ¹²
ɁliuɁ¹²	V;IPFV;2;PST	mi³-ɁliuɁ²	mi³-ɁliuɁ²
tso¹²	V;IPFV;2;PST	mi³-høg²	mi³-tso²²
siég²	V;IPFV;2;PST	mi³-sieg¹²	mi³-sieg¹
sianɁ¹²	V;IPFV;2;PST	mi³-sianɁ¹³	mi³-sianɁ¹
nió²	V;IPFV;2;PST	mi³-nio¹²	mi³-nio¹²
kien¹²	V;IPFV;2;PST	mi³-kien¹³	mi³-kien²³
tsén²	V;IPFV;2;PST	mi³-tsen³	mi³-tsen²
búɁ¹²	V;IPFV;2;PST	mi³-buɁ¹²	mi³-buɁ¹²
mi²+hniang¹ ni³	V;IPFV;2;PST	mi³-mi²+hniang³	mi³-mi²+hniang³¹
mi²+guionɁ¹	V;IPFV;2;PST	mi³-mi²+guionɁ³	mi³-mi²+guion
ɁngióɁ¹²	V;IPFV;2;PST	mi³-ɁngioɁ²	mi³-ɁngioɁ¹
chiágɁ¹²	V;IPFV;2;PST	mi³-chiagɁ²	mi³-chiagɁ¹
tø²+kanɁ¹³	V;IPFV;2;PST	mi³-tø²+kanɁ¹³	mi³-tø²+kanɁ
hiégɁ¹²	V;IPFV;2;PST	mi³-hiegɁ²	mi³-hiegɁ²
ngáɁ¹²	V;IPFV;2;PST	mi³-ngaɁ²	mi³-ngaɁ³²
mi²+Ɂliúg²	V;IPFV;2;PST	mi³-mi²+Ɂliug³	mi³-mi²+Ɂliu
mi²+dsií¹	V;IPFV;2;PST	mi³-mi²+dsii³	mi³-mi²+dsii
tóɁ¹²	V;IPFV;2;PST	mi³-toɁ²	mi³-toɁ²²
tanɁ¹² huu¹²	V;IPFV;2;PST	mi³-tanɁ²	mi³-tanɁ²²¹Ɂ²³
Ɂug¹²	V;IPFV;2;PST	mi³-Ɂug¹³	mi³-Ɂug²³
hái¹²	V;IPFV;2;PST	mi³-hai²	mi³-hai²¹
ián²	V;IPFV;2;PST	mi³-ian¹²	mi³-ian¹²
mi²+Ɂan¹²	V;IPFV;2;PST	mi³-mi²+Ɂan¹³	mi³-mi²+Ɂan¹
dsēn¹²	V;IPFV;2;PST	mi³-dsēn¹³	mi³-dsēn²¹
hiúgɁ²	V;IPFV;2;PST	mi³-hiugɁ³	mi³-hiugɁ³
tsai¹²	V;IPFV;2;PST	mi³-tsai¹²	mi³-tsai²²
pø²+hánɁ²	V;IPFV;2;PST	mi³-pø²+hanɁ¹²	mi³-pø²+hanɁ
Ɂø²+tsúgɁ²	V;IPFV;2;PST	mi³-Ɂø²+tsogɁ²	mi³-Ɂø²+tsog
Ɂéi¹²	V;IPFV;2;PST	mi³-Ɂei¹³	mi³-Ɂei¹³
mi²+kiín¹	V;IPFV;2;PST	mi³-mi²+kiin³	mi³-mi²+kiin
ié²	V;IPFV;2;PST	mi³-ie¹²	mi³-ie¹²
hønɁ¹²	V;IPFV;2;PST	mi³-hønɁ²	mi³-hønɁ¹²
tsøi¹²	V;IPFV;2;PST	mi³-tsøi¹²	mi³-tsøi¹²
gúg²	V;IPFV;2;PST	mi³-gug¹²	mi³-gug¹²
kuǿɁ¹²	V;IPFV;2;PST	mi³-kuøɁ¹²	mi³-kuøɁ¹²
tiánɁ¹²	V;IPFV;2;PST	mi³-tanɁ¹²	mi³-tianɁ¹
hnióɁ²	V;IPFV;2;PST	mi³-hnioɁ²	mi³-hnioɁ³
tsenɁ¹²	V;IPFV;2;PST	mi³-tsēnɁ²	mi³-tsenɁ¹
guieng¹²	V;IPFV;2;PST	mi³-guieng²	mi³-guieng²
ɁǿnɁ²	V;IPFV;2;PST	mi³-ɁøgɁ²	mi³-ɁønɁ²
Ɂe¹²	V;IPFV;2;PST	mi³-Ɂe²	mi³-Ɂe²³²
nang¹²	V;IPFV;2;PST	mi³-nøng²	mi³-nang²²
ngó¹²	V;IPFV;2;PST	mi³-ngo²	mi³-ngo²³
chiángɁ¹²	V;IPFV;2;PST	mi³-chiangɁ³	mi³-chiangɁ³
mi²+kiónɁ²	V;IPFV;2;PST	mi³-mi²+kionɁ³	mi³-mi²+kion
lio¹²	V;IPFV;2;PST	mi³-løg²	mi³-lig²²
ɁmóɁ²	V;IPFV;2;PST	mi³-ɁmoɁ¹²	mi³-ɁmoɁ¹
hniang²	V;IPFV;2;PST	mi³-hniang²	mi³-hniang
sián²	V;IPFV;2;PST	mi³-sian³	mi³-sian¹
tian¹	V;IPFV;2;PST	mi³-tian¹	mi³-tian¹
mi²+kán¹²	V;IPFV;2;PST	mi³-mi²+kan³	mi³-mi²+kan³
guiugɁ²	V;IPFV;2;PST	mi³-guiugɁ²	mi³-guiugɁ
ɁmēɁ¹²	V;IPFV;2;PST	mi³-ɁmēɁ²	mi³-ɁmēɁ²³
nié¹²	V;IPFV;2;PST	mi³-na²	mi³-nie¹³
hngióɁ²	V;IPFV;2;PST	mi³-hngioɁ³	mi³-hngioɁ
ɁenɁ¹²	V;IPFV;2;PST	mi³-ɁenɁ¹³	mi³-ɁenɁ²²
tsēnɁ¹²	V;IPFV;2;PST	mi³-tsēnɁ¹²	mi³-tsēnɁ¹
mḗɁ²	V;IPFV;2;PST	mi³-mēɁ³	mi³-mēɁ³¹
kang²	V;IPFV;2;PST	mi³-kang²	mi³-kang²
liúg²	V;IPFV;2;PST	mi³-log³	mi³-liug²
ngǿi²	V;IPFV;2;PST	mi³-ngai¹²	mi³-ngøi¹
togɁ¹²	V;IPFV;2;PST	mi³-togɁ²	mi³-togɁ²²
kø²+hinɁ¹²	V;IPFV;2;PST	mi³-kø²+hinɁ³	mi³-kø²+hinɁ
hénɁ¹²	V;IPFV;2;PST	mi³-henɁ¹²	mi³-henɁ¹²
siúgɁ²	V;IPFV;2;PST	mi³-siugɁ²	mi³-siugɁ²
Ɂen¹²	V;IPFV;2;PST	mi³-Ɂen²	mi³-Ɂen¹²
hnáɁ¹²	V;IPFV;2;PST	mi³-hnaɁ¹²	mi³-hnaɁ¹²
lánɁ²	V;IPFV;2;PST	mi³-lanɁ¹²	mi³-lanɁ¹
Ɂnie¹²	V;IPFV;2;PST	mi³-Ɂna³	mi³-Ɂnie²²
ngie³	V;IPFV;2;PST	mi³-ngie³	mi³-ngie³
ngieɁ¹³	V;IPFV;2;PST	mi³-ngieɁ¹³	mi³-ngieɁ¹
lióg¹²	V;IPFV;2;PST	mi³-log¹²	mi³-logg¹²
Ɂian²	V;IPFV;2;PST	mi³-Ɂian²	mi³-Ɂian¹
ɁéɁ²	V;IPFV;2;PST	mi³-ɁeɁ²	mi³-ɁeɁ¹²
hngió²	V;IPFV;2;PST	mi³-hngio¹²	mi³-hngio¹
chióg¹²	V;IPFV;2;PST	mi³-chiog³	mi³-chiog³
Ɂme¹²	V;IPFV;2;PST	mi³-Ɂme²	mi³-Ɂme²²
Ɂé²	V;IPFV;2;PST	mi³-Ɂe¹²	mi³-Ɂe¹²
mi²+hu¹	V;IPFV;2;PST	mi³-mi²+hu³	mi³-mi²+hu
kø¹²	V;IPFV;2;PST	mi³-kø²	mi³-kø²²¹
Ɂia¹²	V;IPFV;2;PST	mi³-Ɂia¹²	mi³-Ɂia¹²
u¹+lian¹	V;IPFV;2;PST	mi³-u²+lian¹	mi³-u²+lian
Ɂian¹²	V;IPFV;2;PST	mi³-Ɂian¹²	mi³-Ɂian¹³
bø²+lḗnɁ²	V;IPFV;2;PST	mi³-bø²+lēnɁ²	mi³-bø²+lēnɁ
mi²+dsian¹²	V;IPFV;2;PST	mi³-mi²+dsian¹³	mi³-mi²+dsian
kēn²	V;IPFV;2;PST	mi³-kēn³	mi³-kēn¹²
ɁlanɁ¹²	V;IPFV;2;PST	mi³-ɁlanɁ¹³	mi³-ɁlanɁ²
tiúg²	V;IPFV;2;PST	mi³-tiug¹²	mi³-tiug²
guu²+dsḗn¹³	V;IPFV;2;PST	mi³-guu²+dsēn¹³	mi³-guu²+dsēn
hniá¹²	V;IPFV;2;PST	mi³-hnia¹²	mi³-hnia¹²
hlíɁ¹²	V;IPFV;2;PST	mi³-hløɁ²	mi³-hliɁ²²
Ɂí²	V;IPFV;2;PST	mi³-Ɂu¹²	mi³-Ɂu¹²
séi²	V;IPFV;2;PST	mi³-sei¹²	mi³-sei¹³
ɁlieɁ¹²	V;IPFV;2;PST	mi³-ɁlieɁ²	mi³-ɁlieɁ²
chiúgɁ²	V;IPFV;2;PST	mi³-chiugɁ³	mi³-chiugɁ
lan²	V;IPFV;2;PST	mi³-lan²	mi³-lan¹²
ɁénɁ¹²	V;IPFV;2;PST	mi³-ɁenɁ¹²	mi³-ɁenɁ¹²
tsá¹²	V;IPFV;2;PST	mi³-tsa²	mi³-tsa²²
kuan¹²	V;IPFV;2;PST	mi³-kuan¹²	mi³-kuan¹³
siog²	V;IPFV;2;PST	mi³-siog¹²	mi³-siog¹
huu¹²	V;IPFV;2;PST	mi³-huu³	mi³-huu²²
tsíɁ¹²	V;IPFV;2;PST	mi³-tsiɁ³	mi³-tsiɁ²²
Ɂéng²	V;IPFV;2;PST	mi³-Ɂeng¹²	mi³-Ɂeng²
tan¹³	V;IPFV;2;PST	mi³-tan¹³	mi³-tan¹³
hnóɁ²	V;IPFV;2;PST	mi³-hnoɁ¹²	mi³-hnoɁ¹
ɁlíɁ¹²	V;IPFV;2;PST	mi³-ɁliɁ¹²	mi³-ɁliɁ²²
ku²+guénɁ²	V;IPFV;2;PST	mi³-ku²+guenɁ³	mi³-ku²+guen
hnéi¹²	V;IPFV;2;PST	mi³-hnai²	mi³-hnei¹²
koɁ¹²	V;IPFV;2;PST	mi³-koɁ¹²	mi³-koɁ¹²
kánɁ¹²	V;IPFV;2;PST	mi³-kanɁ¹³	mi³-kanɁ¹²
kionɁ¹²	V;IPFV;2;PST	mi³-kionɁ¹²	mi³-kionɁ¹
Ɂai¹²	V;IPFV;2;PST	mi³-Ɂøi²	mi³-Ɂai²²
dsi²	V;IPFV;2;PST	mi³-dsi¹²	mi³-dsi¹²
mi²+dsiagɁ¹	V;IPFV;2;PST	mi³-mi²+dsiagɁ³	mi³-mi²+dsiag
téng²	V;IPFV;2;PST	mi³-tøng²	mi³-teng²
mi²+ti¹	V;IPFV;2;PST	mi³-mi²+ti³	mi³-mi²+ti
chionɁ¹²	V;IPFV;2;PST	mi³-chionɁ¹³	mi³-chionɁ¹
ngēɁ²	V;IPFV;2;PST	mi³-ngēɁ²	mi³-ngēɁ²
mi²+lei¹³	V;IPFV;2;PST	mi³-mi²+lei¹³	mi³-mi²+lei¹
mi²+liág¹	V;IPFV;2;PST	mi³-mi²+liag¹³	mi³-mi²+liag
guuɁ¹²	V;IPFV;2;PST	mi³-guuɁ²	mi³-guuɁ²²
téiɁ²	V;IPFV;2;PST	mi³-teiɁ¹²	mi³-teiɁ²
neɁ¹²	V;IPFV;2;PST	mi³-neɁ³	mi³-neɁ²²
mi²+gag¹²	V;IPFV;2;PST	mi³-mi²+gag¹³	mi³-mi²+gag¹
høn¹²	V;IPFV;2;PST	mi³-høn²	mi³-høn²²
mi²+dsē¹²	V;IPFV;2;PST	mi³-mi²+dsē¹³	mi³-mi²+dsē¹
nǿɁ²	V;IPFV;2;PST	mi³-nøɁ¹²	mi³-nøɁ¹²
tei²	V;IPFV;2;PST	mi³-tei³	mi³-tei²²
kuø¹²	V;IPFV;2;PST	mi³-kuø²	mi³-kuø²¹
kián²	V;IPFV;2;PST	mi³-kian¹²	mi³-kian¹
hiúɁ²	V;IPFV;2;PST	mi³-hioɁ³	mi³-hiuɁ³
dsén²	V;IPFV;2;PST	mi³-dsen²	mi³-dsen²
ɁiuɁ³ (ɁéɁ¹)	V;IPFV;2;PST	mi³-ɁiuɁ³	mi³-ɁiuɁ³i²³(¹
mi²+huanɁ¹²	V;IPFV;2;PST	mi³-mi²+huanɁ¹³	mi³-mi²+huanɁ
ɁiúɁ¹²	V;IPFV;2;PST	mi³-ɁiuɁ³	mi³-ɁiuɁ³³
hlǿ²	V;IPFV;2;PST	mi³-hlø¹²	mi³-hlø¹²
tan¹²	V;IPFV;2;PST	mi³-tan¹²	mi³-tan²²
tson¹²	V;IPFV;2;PST	mi³-tson¹²	mi³-tson²²
Ɂøin¹²	V;IPFV;2;PST	mi³-Ɂøin¹²	mi³-Ɂøin¹²
dsióɁ¹² hǿg³	V;IPFV;2;PST	mi³-dsioɁ¹²	mi³-dsioɁ¹²³³²
hai¹²	V;IPFV;2;PST	mi³-høi²	mi³-hai²²
Ɂen¹³	V;IPFV;2;PST	mi³-Ɂen¹³	mi³-Ɂen¹³
tanɁ¹²	V;IPFV;2;PST	mi³-tanɁ²	mi³-tanɁ²²
siúɁ²	V;IPFV;2;PST	mi³-siuɁ¹²	mi³-siuɁ³
ɁnangɁ²	V;IPFV;2;PST	mi³-ɁnangɁ¹²	mi³-ɁnangɁ
hlian¹²	V;IPFV;2;PST	mi³-hlian¹²	mi³-hlian¹
tion¹²	V;IPFV;2;PST	mi³-ton¹²	mi³-tion¹²
chiógɁ² ( hmøi²)	V;IPFV;2;PST	mi³-chiogɁ³	mi³-chiogɁ³²¹²³(
Ɂø²+tsóɁ¹²	V;IPFV;2;PST	mi³-Ɂø²+tsoɁ²	mi³-Ɂø²+tsoɁ
nøɁ¹²	V;IPFV;2;PST	mi³-nøɁ²	mi³-nøɁ²²
mi²+hngiáng¹	V;IPFV;2;PST	mi³-mi²+hngiang¹³	mi³-mi²+hngian
Ɂlí²	V;IPFV;2;PST	mi³-Ɂli¹²	mi³-Ɂli¹²
ɁlogɁ²	V;IPFV;2;PST	mi³-ɁlogɁ²	mi³-ɁlogɁ²
mi²+ɁmaɁ¹³	V;IPFV;2;PST	mi³-mi²+ɁmaɁ¹³	mi³-mi²+ɁmaɁ
siág¹²	V;IPFV;2;PST	mi³-siog³	mi³-siag¹²
dsiog¹²	V;IPFV;2;PST	mi³-dsiog³	mi³-dsiog¹
kienɁ¹²	V;IPFV;2;PST	mi³-kienɁ¹³	mi³-kienɁ¹
ɁløaɁ¹²	V;IPFV;2;PST	mi³-ɁløaɁ³	mi³-ɁløaɁ²
dsúgɁ¹²	V;IPFV;2;PST	mi³-dsugɁ¹²	mi³-dsugɁ¹
héi²	V;IPFV;2;PST	mi³-hi²	mi³-hei¹²
hnḗ¹²	V;IPFV;2;PST	mi³-hnē¹²	mi³-hnē¹³
ɁóɁ¹²	V;IPFV;2;PST	mi³-ɁuanɁ¹²	mi³-ɁoɁ²Ɂ
mi²+tián² (dsǿa¹²)	V;IPFV;2;PST	mi³-mi²+tian³	mi³-mi²+tian³²³(((
u²+nio¹³	V;IPFV;2;PST	mi³-u²+nio³	mi³-u²+nio³
mi²+Ɂog¹³	V;IPFV;2;PST	mi³-mi²+Ɂog³	mi³-mi²+Ɂog³
lēɁ²	V;IPFV;2;PST	mi³-lēɁ³	mi³-lēɁ³²
tsø²+nióɁ²	V;IPFV;2;PST	mi³-tsø²+nioɁ³	mi³-tsø²+nio
kon¹²	V;IPFV;2;PST	mi³-kon¹²	mi³-kon¹²
bḗn²	V;IPFV;2;PST	mi³-bēn¹²	mi³-bēn¹²
mi²+hlēnɁ¹	V;IPFV;2;PST	mi³-mi²+hlēnɁ³	mi³-mi²+hlēn
hmo¹²	V;IPFV;2;PST	mi³-hmo²	mi³-hmo²³
tei¹²	V;IPFV;2;PST	mi³-tei²	mi³-tei²²
mi²+hniang¹ dsǿa¹²	V;IPFV;2;PST	mi³-mi²+hniang³	mi³-mi²+hniang³¹³(
huánɁ¹²	V;IPFV;2;PST	mi³-huanɁ¹²	mi³-huanɁ¹
ɁmíɁ²	V;IPFV;2;PST	mi³-ɁmiɁ²	mi³-ɁmiɁ²
hiég²	V;IPFV;2;PST	mi³-hieg¹²	mi³-hieg²
Ɂēn¹²	V;IPFV;2;PST	mi³-Ɂēn¹²	mi³-Ɂēn¹²
kánɁ²	V;IPFV;2;PST	mi³-kanɁ¹²	mi³-kanɁ¹
ɁéɁ¹²	V;IPFV;2;PST	mi³-ɁeɁ¹²	mi³-ɁeɁ¹³
gḗɁ²	V;IPFV;2;PST	mi³-gēɁ²	mi³-gēɁ²²
ɁagɁ²	V;IPFV;2;PST	mi³-ɁagɁ³	mi³-ɁagɁ²
nung²	V;IPFV;2;PST	mi³-nung¹²	mi³-nung¹
kḗn²	V;IPFV;2;PST	mi³-kēn²	mi³-kēn²¹
hniuɁ²	V;IPFV;2;PST	mi³-hniang²	mi³-hniuɁ²
iaɁ¹²	V;IPFV;2;PST	mi³-iaɁ³	mi³-iaɁ³²
u²+Ɂai¹²	V;IPFV;2;PST	mi³-u²+Ɂai¹²	mi³-u²+Ɂai¹
ngo²	V;IPFV;2;PST	mi³-ngo²	mi³-ngo²²
hug²	V;IPFV;2;PST	mi³-hug²	mi³-hug¹³
lø²+liugɁ³	V;IPFV;2;PST	mi³-lø²+liugɁ³	mi³-lø²+liug
dsen¹²	V;IPFV;2;PST	mi³-dsen¹²	mi³-dsen²¹
tsáiɁ¹²	V;IPFV;2;PRS	huaiɁ¹²	tsaiɁ²
guiágɁ¹²	V;IPFV;2;PRS	guiagɁ¹²	guiagɁ¹
bø²+hmé²	V;IPFV;2;PRS	bø²+hme²	bø²+hme
ɁnóɁ¹² dsí²	V;IPFV;2;PRS	ɁnoɁ¹²	ɁnoɁ¹²³¹³
dsánɁ¹²	V;IPFV;2;PRS	dsanɁ¹²	dsanɁ¹
Ɂuø¹²	V;IPFV;2;PRS	Ɂuø³	Ɂuø³³
guión²	V;IPFV;2;PRS	guion³	guion³
lǿɁ²	V;IPFV;2;PRS	lēɁ²	løɁ²²
tií²	V;IPFV;2;PRS	tii¹²	tii¹²
guiénɁ²	V;IPFV;2;PRS	guienɁ¹²	guienɁ
héinɁ¹²	V;IPFV;2;PRS	heinɁ³	heinɁ¹
mi²+kionɁ¹	V;IPFV;2;PRS	mi²+kionɁ¹³	mi²+kion
hénɁ²	V;IPFV;2;PRS	henɁ¹³	henɁ¹
chi²+dsán²	V;IPFV;2;PRS	chi²+dsan²	chi²+dsa
mi²+dsøg¹²	V;IPFV;2;PRS	mi²+dsøg¹³	mi²+dsøg
guieɁ¹²	V;IPFV;2;PRS	guieɁ²	guieɁ²
mi²+chian¹²	V;IPFV;2;PRS	mi²+chian³	mi²+chian
guiúg²	V;IPFV;2;PRS	guiug³	guiug³
Ɂon¹²	V;IPFV;2;PRS	Ɂøng²	Ɂon¹²
niá¹²	V;IPFV;2;PRS	nia¹²	nia¹²
Ɂan¹²	V;IPFV;2;PRS	Ɂan¹³	Ɂan¹¹
dság¹²	V;IPFV;2;PRS	gogɁ²	dsag²²
tsanɁ¹²	V;IPFV;2;PRS	huanɁ³	tsanɁ¹
tánɁ¹²	V;IPFV;2;PRS	tanɁ¹²	tanɁ¹²
gógɁ¹²	V;IPFV;2;PRS	gogɁ¹²	gogɁɁ²
mi²+hénɁ²	V;IPFV;2;PRS	mi²+henɁ³	mi²+henɁ
ti²+líɁ¹	V;IPFV;2;PRS	ti²+leɁ¹	ti²+leɁ
hánɁ¹²	V;IPFV;2;PRS	hanɁ¹²	hanɁ¹²
mi²+kiíngɁ²	V;IPFV;2;PRS	mi²+kiingɁ³	mi²+kiing
ɁúgɁ²	V;IPFV;2;PRS	ɁogɁ³	ɁugɁ³
hiúg²	V;IPFV;2;PRS	hiug³	hiug³
tian¹²	V;IPFV;2;PRS	tian¹³	tian¹³
mi²+hmḗ²	V;IPFV;2;PRS	mi²+hmē³	mi²+hmē
ngē¹²	V;IPFV;2;PRS	ngē¹³	ngē¹²
lanɁ¹²	V;IPFV;2;PRS	lanɁ¹²	lanɁ¹²
ngái¹²	V;IPFV;2;PRS	ngai³	ngai¹²
tión²	V;IPFV;2;PRS	ton²	tion¹
tsø²+kuenɁ¹²	V;IPFV;2;PRS	tsø²+kuenɁ¹²	tsø²+kuenɁ
hngiáɁ²	V;IPFV;2;PRS	hngiaɁ²	hngiaɁ
ngioɁ¹²	V;IPFV;2;PRS	ngioɁ²	ngioɁ²
ɁlianɁ²	V;IPFV;2;PRS	ɁlianɁ²	ɁlianɁ
hngióɁ¹²	V;IPFV;2;PRS	hngioɁ¹³	hngioɁ¹
tsǿɁ¹²	V;IPFV;2;PRS	tsøɁ¹²	tsøɁ¹²
guiú²	V;IPFV;2;PRS	guiu¹²	guiu¹
ta¹²	V;IPFV;2;PRS	ta²	ta²³¹
rónɁ¹²	V;IPFV;2;PRS	ranɁ¹²	ranɁ¹²
nioɁ²	V;IPFV;2;PRS	nioɁ²	nioɁ²
huúɁ¹²	V;IPFV;2;PRS	huuɁ³	huuɁ³³
kágɁ¹²	V;IPFV;2;PRS	kagɁ³	kagɁ¹²
guái²	V;IPFV;2;PRS	guai¹²	guai¹
chi²+kián²	V;IPFV;2;PRS	chi²+kian³	chi²+kia
hian¹²	V;IPFV;2;PRS	han¹²	hian¹³
kión²	V;IPFV;2;PRS	kion³	kion³
lóɁ¹²	V;IPFV;2;PRS	loɁ²	loɁ²Ɂ
tsog¹²	V;IPFV;2;PRS	tsog¹³	tsog²²
hnḗɁ²	V;IPFV;2;PRS	hnēɁ³	hnēɁ³
mi²+ɁḗɁ²	V;IPFV;2;PRS	mi²+ɁēɁ³	mi²+ɁēɁ
tø²+ɁénɁ¹²	V;IPFV;2;PRS	tø²+ɁenɁ³	tø²+ɁenɁ
uénɁ²	V;IPFV;2;PRS	uenɁ²	uenɁ²
rón²	V;IPFV;2;PRS	ron³	ran³¹
Ɂo¹²	V;IPFV;2;PRS	huaiɁ²	Ɂo²i²
hǿɁ²	V;IPFV;2;PRS	høɁ¹²	høɁ¹²
hnǿ²	V;IPFV;2;PRS	hnø¹²	hnø¹²
hnaiɁ¹²	V;IPFV;2;PRS	hnaiɁ³	hnaiɁ²
tai²	V;IPFV;2;PRS	tai³	tai³²
ɁuǿɁ¹²	V;IPFV;2;PRS	ɁuøɁ¹³	ɁuøɁ¹²
kán²	V;IPFV;2;PRS	kan¹²	kan¹²
háinɁ¹²	V;IPFV;2;PRS	hainɁ²	hainɁ²
dsø²+huen¹³	V;IPFV;2;PRS	dsø²+huen¹³	dsø²+huen
lag²	V;IPFV;2;PRS	lag¹²	lag¹²
kiúgɁ²	V;IPFV;2;PRS	kiugɁ³	kiugɁ³
bán²	V;IPFV;2;PRS	ban¹²	ban¹²
kiuɁ¹²	V;IPFV;2;PRS	kiuɁ²	kiuɁ²³
mi²+gug¹	V;IPFV;2;PRS	mi²+gug¹	mi²+gug
gog²	V;IPFV;2;PRS	gog¹²	gog¹²
lán¹²	V;IPFV;2;PRS	lan¹²	lan²²
Ɂno¹²	V;IPFV;2;PRS	Ɂnøng²	Ɂno²²
mi²+kien¹²	V;IPFV;2;PRS	mi²+kien¹³	mi²+kien
chióɁ¹²	V;IPFV;2;PRS	chioɁ³	chioɁ³
ngiéɁ¹²	V;IPFV;2;PRS	ngieɁ³	ngieɁ³
siúg²	V;IPFV;2;PRS	siug³	siug¹
huánɁ²	V;IPFV;2;PRS	huanɁ¹²	huanɁ¹
dsiag¹²	V;IPFV;2;PRS	dsiag²	dsiag¹
guiónɁ²	V;IPFV;2;PRS	guionɁ³	guionɁ
hanɁ¹² dsǿa¹²	V;IPFV;2;PRS	hanɁ¹²	hanɁ¹²³²¹²
tsogɁ² hmøi²	V;IPFV;2;PRS	tsogɁ²	tsogɁ²¹³¹Ɂ
ɁnáiɁ¹²	V;IPFV;2;PRS	ɁnaiɁ²	ɁnaiɁ²
hnio³	V;IPFV;2;PRS	hnio³	hnio³
Ɂngio¹²	V;IPFV;2;PRS	Ɂngio¹²	Ɂngio¹
guǿn¹²	V;IPFV;2;PRS	guøn¹²	guøn¹²
tán¹²	V;IPFV;2;PRS	tēn¹²	tan¹²
tson²	V;IPFV;2;PRS	tson²	tson¹
hen¹²	V;IPFV;2;PRS	hen¹²	hen¹¹
hián²	V;IPFV;2;PRS	hian¹²	hian¹
huǿin¹²	V;IPFV;2;PRS	huøin²	huøin²
tsón¹²	V;IPFV;2;PRS	tson¹²	tson³²
kii²+túg²	V;IPFV;2;PRS	kii²+tog³	kii²+tog
kii²+tág¹²	V;IPFV;2;PRS	kii²+tag²	kii²+tag
hngia¹²	V;IPFV;2;PRS	han¹³	han¹³¹
køn¹²	V;IPFV;2;PRS	køn²	køn²²
Ɂiog²	V;IPFV;2;PRS	Ɂiog²	Ɂiog²
tsog²	V;IPFV;2;PRS	tsog²	tsog²
kugɁ¹²	V;IPFV;2;PRS	kugɁ¹³	kugɁ¹²
ɁioɁ¹²	V;IPFV;2;PRS	ɁianɁ¹²	ɁioɁ¹²
hág¹²	V;IPFV;2;PRS	hag¹³	hag¹³
hmóɁ¹²	V;IPFV;2;PRS	hmoɁ³	hmoɁ³¹
nēɁ¹²	V;IPFV;2;PRS	nēɁ¹²	nēɁ¹²
húɁ²	V;IPFV;2;PRS	huɁ¹²	huɁ¹²
héin¹²	V;IPFV;2;PRS	hein³	hein¹³
dsúgɁ²	V;IPFV;2;PRS	dsugɁ³	dsugɁ³
ngie¹²	V;IPFV;2;PRS	ngie¹³	ngie¹²
kieg²	V;IPFV;2;PRS	kieg¹²	kieg¹
mi²+tan¹²	V;IPFV;2;PRS	mi²+tan³	mi²+tan³
ɁēnɁ¹²	V;IPFV;2;PRS	ɁēnɁ²	ɁēnɁ²²
Ɂlúg²	V;IPFV;2;PRS	Ɂlug²	Ɂlug²
møa¹²	V;IPFV;2;PRS	møa²	møa²²
guen²	V;IPFV;2;PRS	guen²	guen¹
hmǿɁ¹²	V;IPFV;2;PRS	hmøɁ²	hmøɁ¹²
dsie¹²	V;IPFV;2;PRS	dsie²	dsie¹²
tsénɁ²	V;IPFV;2;PRS	tsēnɁ²	tsēnɁ³
Ɂméi¹²	V;IPFV;2;PRS	Ɂmei³	Ɂmei³²
tø²+húg³	V;IPFV;2;PRS	tø²+hug³	tø²+hug
kug²	V;IPFV;2;PRS	kug²	kug¹²
mi²+Ɂlí¹	V;IPFV;2;PRS	mi²+Ɂli³	mi²+Ɂli
dsen³ (kaɁ³)	V;IPFV;2;PRS	dsen³	dsen³³³³³¹
chiogɁ¹²	V;IPFV;2;PRS	chiogɁ¹²	chiogɁ¹
chi²+méɁ²	V;IPFV;2;PRS	chi²+meɁ¹²	chi²+meɁ
chi²+lánɁ²	V;IPFV;2;PRS	chi²+lanɁ¹²	chi²+lan
hánɁ²	V;IPFV;2;PRS	hanɁ¹²	hanɁ¹
tsø²+kuønɁ¹²	V;IPFV;2;PRS	tsø²+kuønɁ¹²	tsø²+kuønɁ
mi²+kuuɁ¹²	V;IPFV;2;PRS	mi²+kuuɁ¹³	mi²+kuuɁ
tø²+gugɁ¹²	V;IPFV;2;PRS	tø²+gugɁ¹²	tø²+gugɁ
mi²+hlíɁ²	V;IPFV;2;PRS	mi²+hliɁ³	mi²+hliɁ
mi²+níɁ¹	V;IPFV;2;PRS	mi²+niɁ³	mi²+niɁ
búɁ²	V;IPFV;2;PRS	buɁ¹²	buɁ¹²
Ɂiei¹²	V;IPFV;2;PRS	Ɂiei²	Ɂiei¹²
niuɁ³	V;IPFV;2;PRS	niuɁ³	niuɁ³
kién¹²	V;IPFV;2;PRS	kien¹³	kien¹²
chión²	V;IPFV;2;PRS	chion³	chion³
guianɁ¹²	V;IPFV;2;PRS	guianɁ²	guianɁ¹
hmḗɁ²	V;IPFV;2;PRS	hmēɁ³	hmēɁ³
dsø²+togɁ¹²	V;IPFV;2;PRS	dsø²+togɁ¹²	dsø²+togɁ
dsiég¹²	V;IPFV;2;PRS	dsieg¹²	dsieg¹
mi²+dsíg²	V;IPFV;2;PRS	mi²+dsig³	mi²+dsig
tǿɁ²	V;IPFV;2;PRS	tøa¹²	tøɁ¹²
ngøɁ¹²	V;IPFV;2;PRS	ngøɁ³	ngøɁ³³
mi²+gan¹²	V;IPFV;2;PRS	mi²+gan¹³	mi²+gan¹
lieɁ¹²	V;IPFV;2;PRS	laɁ³	lieɁ¹²
ɁiéiɁ¹²	V;IPFV;2;PRS	ɁieiɁ²	ɁieiɁ²
ti²+dsǿ²	V;IPFV;2;PRS	ti²+dsø³	ti²+dsø
káiɁ¹²	V;IPFV;2;PRS	kaiɁ²	kaiɁ¹²
chi²+hné¹	V;IPFV;2;PRS	chi²+hne³	chi²+hne
guen¹²	V;IPFV;2;PRS	guen³	guen¹²
hmáɁ² (dsǿa¹²)	V;IPFV;2;PRS	hmaɁ¹³	hmaɁ¹³¹²¹²²
mi²+kánɁ²	V;IPFV;2;PRS	mi²+kanɁ³	mi²+kanɁ
Ɂuan¹²	V;IPFV;2;PRS	Ɂuan¹³	Ɂuan¹³
li²	V;IPFV;2;PRS	li¹²	li¹²
Ɂúg²	V;IPFV;2;PRS	Ɂug¹²	Ɂug¹²
kēnɁ¹²	V;IPFV;2;PRS	kēnɁ²	kēnɁ²³
dsióɁ¹²	V;IPFV;2;PRS	dsioɁ³	dsioɁ³
tsiɁ¹²	V;IPFV;2;PRS	tsøɁ²	tsiɁ²²
kiéɁ¹²	V;IPFV;2;PRS	kieɁ³	kieɁ¹²
tsánɁ²	V;IPFV;2;PRS	tsanɁ¹²	tsanɁ¹
bén²	V;IPFV;2;PRS	ben¹²	ben¹²
hlái²	V;IPFV;2;PRS	hlai¹²	hlai¹
héɁ²	V;IPFV;2;PRS	heɁ³	heɁ¹²
ɁnióɁ¹²	V;IPFV;2;PRS	ɁnioɁ¹²	ɁnioɁ³
ngiú²	V;IPFV;2;PRS	ngiu²	ngiu²
lúg²	V;IPFV;2;PRS	lug²	lug²²
ɁiánɁ²	V;IPFV;2;PRS	ɁianɁ¹²	ɁianɁ¹
mi²+Ɂai¹	V;IPFV;2;PRS	mi²+Ɂai¹	mi²+Ɂai
tsí¹²	V;IPFV;2;PRS	tsi²	tsi²²
hlán²	V;IPFV;2;PRS	hlan³	hlan¹
tsen¹²	V;IPFV;2;PRS	tsēn³	tsen¹¹
dsan²	V;IPFV;2;PRS	dsan²	dsan²
ɁónɁ²	V;IPFV;2;PRS	ɁonɁ³	ɁonɁɁ
hmáɁ² (ta³)	V;IPFV;2;PRS	hmaɁ¹³	hmaɁ¹³¹²n
tiun¹²	V;IPFV;2;PRS	tøng¹²	tiun¹²
dsǿɁ²	V;IPFV;2;PRS	dsøɁ¹²	dsøɁ²
ha¹²	V;IPFV;2;PRS	ha¹³	ha²³Ɂ
ti²+li¹	V;IPFV;2;PRS	ti²+li³	ti²+li
mi²+ngḗɁ¹	V;IPFV;2;PRS	mi²+ngēɁ³	mi²+ngēɁ
guiúnɁ¹²	V;IPFV;2;PRS	guionɁ¹³	guiunɁ¹
hliánɁ²	V;IPFV;2;PRS	hlianɁ¹³	hlianɁ
hngiíɁ²	V;IPFV;2;PRS	hngieɁ¹²	hngieɁ
kanɁ¹²	V;IPFV;2;PRS	kanɁ¹²	kanɁ¹²
Ɂmǿi²	V;IPFV;2;PRS	Ɂmai¹²	Ɂmøi¹
chi²+ngió²	V;IPFV;2;PRS	chi²+ngio³	chi²+ngi
hnó²	V;IPFV;2;PRS	hno³	hno¹²
Ɂnē¹²	V;IPFV;2;PRS	Ɂnē¹²	Ɂnē¹²
Ɂngieng¹²	V;IPFV;2;PRS	Ɂngieng²	Ɂngieng²
hlég²	V;IPFV;2;PRS	hleg²	hleg²
dsii²+lian¹	V;IPFV;2;PRS	dsii²+lian¹	dsii²+lia
hné¹²	V;IPFV;2;PRS	hnē³	hne³³
gǿi¹²	V;IPFV;2;PRS	gøi²	gøi²²
tsón²	V;IPFV;2;PRS	tson³	tson³
chiog¹²	V;IPFV;2;PRS	chiog¹²	chiog¹
húgɁ²	V;IPFV;2;PRS	hogɁ¹²	hugɁ³
mái¹²	V;IPFV;2;PRS	mai²	mai²³
mi²+rø¹²	V;IPFV;2;PRS	mi²+rø³	mi²+rø³
tiú²	V;IPFV;2;PRS	tiu¹²	tiu¹²
dsogɁ¹²	V;IPFV;2;PRS	dsogɁ¹²	dsogɁ¹
hiugɁ¹²	V;IPFV;2;PRS	hiugɁ³	hiugɁ³
kií¹²	V;IPFV;2;PRS	kø²	kii¹²
kian¹²	V;IPFV;2;PRS	kian¹³	kian¹³
mi²+hínɁ²	V;IPFV;2;PRS	mi²+hinɁ³	mi²+hinɁ
Ɂngiéng¹²	V;IPFV;2;PRS	Ɂngieng²	Ɂngieng²
ɁliuɁ¹²	V;IPFV;2;PRS	ɁliuɁ²	ɁliuɁ²
tso¹²	V;IPFV;2;PRS	høg²	tso²²
siég²	V;IPFV;2;PRS	sieg¹²	sieg¹
kien¹²	V;IPFV;2;PRS	kien¹³	kien¹³
búɁ¹²	V;IPFV;2;PRS	buɁ¹²	buɁ¹²
Ɂuan²	V;IPFV;2;PRS	Ɂuan²	Ɂuan¹
tagɁ²	V;IPFV;2;PRS	tagɁ¹²	tagɁ¹
kúgɁ²	V;IPFV;2;PRS	kogɁ³	kugɁ³
ɁngióɁ¹²	V;IPFV;2;PRS	ɁngioɁ²	ɁngioɁ¹
Ɂma¹²	V;IPFV;2;PRS	Ɂma²	Ɂma²²
chiágɁ¹²	V;IPFV;2;PRS	chiagɁ²	chiagɁ¹
ngáɁ¹²	V;IPFV;2;PRS	ngaɁ²	ngaɁ³¹
tanɁ¹² huu¹²	V;IPFV;2;PRS	tanɁ²	tanɁ²¹²³¹²
kán² guiing²	V;IPFV;2;PRS	kan¹²	kan¹²²¹¹³¹
Ɂug¹²	V;IPFV;2;PRS	Ɂug¹³	Ɂug¹³
hái¹²	V;IPFV;2;PRS	hai²	hai²²
ián²	V;IPFV;2;PRS	ian¹²	ian¹²
mi²+Ɂan¹²	V;IPFV;2;PRS	mi²+Ɂan¹³	mi²+Ɂan¹
dsēn¹²	V;IPFV;2;PRS	dsēn¹³	dsēn²³
hiúgɁ²	V;IPFV;2;PRS	hiugɁ³	hiugɁ³
lá¹²	V;IPFV;2;PRS	la²	la²²Ɂ
bí²	V;IPFV;2;PRS	bi¹²	bi¹²
Ɂø²+tsúgɁ²	V;IPFV;2;PRS	Ɂø²+tsogɁ²	Ɂø²+tsog
ɁaiɁ²	V;IPFV;2;PRS	ɁaiɁ¹²	ɁaiɁ¹
Ɂéi¹²	V;IPFV;2;PRS	Ɂei¹³	Ɂei¹³
mi²+kiín¹	V;IPFV;2;PRS	mi²+kiin³	mi²+kiin
ié²	V;IPFV;2;PRS	ie¹²	ie¹²
hønɁ¹²	V;IPFV;2;PRS	hønɁ²	hønɁ²²
tsøi¹²	V;IPFV;2;PRS	tsøi¹²	tsøi¹²
gúg²	V;IPFV;2;PRS	gug¹²	gug¹²
kuǿɁ¹²	V;IPFV;2;PRS	kuøɁ¹²	kuøɁ¹²
tiánɁ¹²	V;IPFV;2;PRS	tanɁ¹²	tianɁ¹
tsenɁ¹²	V;IPFV;2;PRS	tsenɁ¹²	tsenɁ¹
ɁǿnɁ²	V;IPFV;2;PRS	ɁøgɁ²	ɁønɁ²
Ɂe¹²	V;IPFV;2;PRS	Ɂe²	Ɂe²iɁ
ngó¹²	V;IPFV;2;PRS	ngo²	ngo²³
chiángɁ¹²	V;IPFV;2;PRS	chiangɁ³	chiangɁ³
mi²+kiónɁ²	V;IPFV;2;PRS	mi²+kionɁ³	mi²+kion
kiagɁ¹²	V;IPFV;2;PRS	kiagɁ²	kiagɁ³
lio¹²	V;IPFV;2;PRS	løg²	lio²Ɂ
hniang²	V;IPFV;2;PRS	hniang²	hniang
tian¹	V;IPFV;2;PRS	tian¹	tian¹
mi²+kán¹²	V;IPFV;2;PRS	mi²+kan³	mi²+kan³
guiugɁ²	V;IPFV;2;PRS	guiugɁ²	guiugɁ
ɁmēɁ¹²	V;IPFV;2;PRS	ɁmēɁ²	ɁmēɁ²¹
mi²+hní¹	V;IPFV;2;PRS	mi²+hni³	mi²+hni
nié¹²	V;IPFV;2;PRS	na²	nie¹²
hngióɁ²	V;IPFV;2;PRS	hngioɁ³	hngioɁ
ɁenɁ¹²	V;IPFV;2;PRS	ɁenɁ¹³	ɁenɁ¹²
tsēnɁ¹²	V;IPFV;2;PRS	tsēnɁ¹²	tsēnɁ¹
mḗɁ²	V;IPFV;2;PRS	mēɁ³	mēɁ³¹
kang²	V;IPFV;2;PRS	kang²	kang¹
liúg²	V;IPFV;2;PRS	log³	liug¹
hḗɁ²	V;IPFV;2;PRS	hēɁ²	hēɁ²²
siúgɁ²	V;IPFV;2;PRS	siugɁ²	siugɁ²
Ɂnie¹²	V;IPFV;2;PRS	Ɂna³	Ɂnie¹²
ngie³	V;IPFV;2;PRS	ngie³	ngie³
ngieɁ¹³	V;IPFV;2;PRS	ngieɁ¹³	ngieɁ¹
lióg¹²	V;IPFV;2;PRS	log¹²	liog¹²
mi²+gan¹	V;IPFV;2;PRS	mi²+gan¹	mi²+gan
Ɂian²	V;IPFV;2;PRS	Ɂian²	Ɂian¹
ɁliágɁ¹²	V;IPFV;2;PRS	ɁliagɁ²	ɁliagɁ¹
Ɂnai¹²	V;IPFV;2;PRS	Ɂnøi²	Ɂnai¹²
chióg¹²	V;IPFV;2;PRS	chiog³	chiog³
Ɂme¹²	V;IPFV;2;PRS	Ɂme²	Ɂme²³
Ɂé²	V;IPFV;2;PRS	Ɂe¹²	Ɂe¹²
Ɂmóng¹²	V;IPFV;2;PRS	Ɂmong¹²	Ɂmong¹
mi²+hu¹	V;IPFV;2;PRS	mi²+hu³	mi²+hu
Ɂog¹²	V;IPFV;2;PRS	Ɂog¹²	Ɂog¹²
kø¹²	V;IPFV;2;PRS	kø²	kø²²Ɂ
Ɂia¹²	V;IPFV;2;PRS	Ɂia¹²	Ɂia¹²
u¹+lian¹	V;IPFV;2;PRS	u²+lian¹	u²+lian
Ɂian¹²	V;IPFV;2;PRS	Ɂian¹²	Ɂian¹²
bø²+lḗnɁ²	V;IPFV;2;PRS	bø²+lēnɁ²	bø²+lēnɁ
tø²+dsḗn³	V;IPFV;2;PRS	tø²+dsēn³	tø²+dsēn
mi²+dsian¹²	V;IPFV;2;PRS	mi²+dsian¹³	mi²+dsian
kiang¹²	V;IPFV;2;PRS	kiang¹³	kiang¹
ɁánɁ²	V;IPFV;2;PRS	ɁanɁ¹²	ɁanɁ²
tiúg²	V;IPFV;2;PRS	tiug¹²	tiug¹
guiánɁ¹²	V;IPFV;2;PRS	guianɁ¹²	guianɁ¹
hniá¹²	V;IPFV;2;PRS	hnia¹²	hnia¹²
hlíɁ¹²	V;IPFV;2;PRS	hløɁ²	hliɁ²²
Ɂí²	V;IPFV;2;PRS	Ɂu¹²	Ɂi¹²
séi²	V;IPFV;2;PRS	sei¹²	sei¹²
ɁlieɁ¹²	V;IPFV;2;PRS	ɁlieɁ²	ɁlieɁ²
ieg¹²	V;IPFV;2;PRS	øg²	ieg³³
rain¹²	V;IPFV;2;PRS	rain¹²	rain¹²
hog¹²	V;IPFV;2;PRS	hog¹²	hog¹²
køgɁ²	V;IPFV;2;PRS	køgɁ²	køgɁ²
chiúgɁ²	V;IPFV;2;PRS	chiugɁ³	chiugɁ
lan²	V;IPFV;2;PRS	lan²	lan²²
ɁénɁ¹²	V;IPFV;2;PRS	ɁenɁ¹²	ɁenɁ¹²
tsá¹²	V;IPFV;2;PRS	tsa²	tsa²³
kuan¹²	V;IPFV;2;PRS	kuan¹²	kuan¹³
guiég¹²	V;IPFV;2;PRS	guieg²	guieg²
huu¹²	V;IPFV;2;PRS	huu³	huu²²
tsíɁ¹²	V;IPFV;2;PRS	tsøɁ²	tsiɁ²²
Ɂéng²	V;IPFV;2;PRS	Ɂeng¹²	Ɂeng¹
tan¹³	V;IPFV;2;PRS	tan¹³	tan¹³
ɁiíɁ²	V;IPFV;2;PRS	ɁiiɁ¹²	ɁiiɁ²
hnóɁ²	V;IPFV;2;PRS	hnoɁ¹²	hnoɁ³
ɁlíɁ¹²	V;IPFV;2;PRS	ɁliɁ¹²	ɁliɁ²²
ku²+guénɁ²	V;IPFV;2;PRS	ku²+guenɁ³	ku²+guen
koɁ¹²	V;IPFV;2;PRS	koɁ¹²	koɁ¹²
Ɂán¹² ɁogɁ¹²	V;IPFV;2;PRS	Ɂan¹²	Ɂan¹²³¹a¹²
gúɁ¹²	V;IPFV;2;PRS	guɁ²	guɁ¹²
kionɁ¹²	V;IPFV;2;PRS	kionɁ¹²	kionɁ¹
Ɂai¹²	V;IPFV;2;PRS	Ɂøi²	Ɂai²³
dsi²	V;IPFV;2;PRS	dsi¹²	dsi¹²
mi²+dsiagɁ¹	V;IPFV;2;PRS	mi²+dsiagɁ³	mi²+dsiag
mi²+ti¹	V;IPFV;2;PRS	mi²+ti³	mi²+ti
chionɁ¹²	V;IPFV;2;PRS	chionɁ¹³	chionɁ¹
ngēɁ²	V;IPFV;2;PRS	ngēɁ²	ngēɁ²
mi²+lei¹³	V;IPFV;2;PRS	mi²+lei¹³	mi²+lei¹
tógɁ¹²	V;IPFV;2;PRS	tugɁ²	togɁ¹¹
guuɁ¹²	V;IPFV;2;PRS	guuɁ²	guuɁ²²
ɁlianɁ¹²	V;IPFV;2;PRS	ɁlianɁ¹²	ɁlianɁ¹
dsanɁ¹²	V;IPFV;2;PRS	dsanɁ¹²	dsanɁ¹
høn¹²	V;IPFV;2;PRS	høn²	høn²²
hógɁ¹²	V;IPFV;2;PRS	ngieɁ¹²	hogɁɁ¹
mi²+dsē¹²	V;IPFV;2;PRS	mi²+dsē¹³	mi²+dsē¹
nǿɁ²	V;IPFV;2;PRS	nøɁ¹²	nøɁ¹²
hngiú²	V;IPFV;2;PRS	hngiu¹²	hngiu¹
tei²	V;IPFV;2;PRS	tei³	tei³²
kián²	V;IPFV;2;PRS	kian¹²	kian¹
dsén²	V;IPFV;2;PRS	dsen²	dsen²
mi²+huanɁ¹²	V;IPFV;2;PRS	mi²+huanɁ¹³	mi²+huanɁ
ɁiúɁ¹²	V;IPFV;2;PRS	ɁiuɁ³	ɁiuɁ³¹
kiiɁ²	V;IPFV;2;PRS	kaɁ¹²	kiiɁ¹
hlǿ²	V;IPFV;2;PRS	hlø¹²	hlø¹²
ti²+dsøa¹²	V;IPFV;2;PRS	ti²+dsøa²	ti²+dsøa
len¹² dsǿa¹²	V;IPFV;2;PRS	len¹²	len¹²³³³¹²
tson¹²	V;IPFV;2;PRS	tson¹²	tson¹¹
Ɂøin¹²	V;IPFV;2;PRS	Ɂøin¹²	Ɂøin¹²
dsióɁ¹² hǿg³	V;IPFV;2;PRS	dsioɁ¹²	dsioɁ¹²²n¹
chi²+láɁ²	V;IPFV;2;PRS	chi²+laɁ¹²	chi²+laɁ
hai¹²	V;IPFV;2;PRS	høi²	hai²³
siúɁ²	V;IPFV;2;PRS	siuɁ¹²	siuɁ³
ɁnangɁ²	V;IPFV;2;PRS	ɁnangɁ¹²	ɁnangɁ
hlian¹²	V;IPFV;2;PRS	hlian¹²	hlian¹
chiógɁ² ( hmøi²)	V;IPFV;2;PRS	chiogɁ³	chiogɁ³³³(³(
nøɁ¹²	V;IPFV;2;PRS	nøɁ²	nøɁ²²
Ɂlí²	V;IPFV;2;PRS	Ɂli¹²	Ɂli¹²
ɁlogɁ²	V;IPFV;2;PRS	ɁlogɁ²	ɁlogɁ²
mi²+ɁmaɁ¹³	V;IPFV;2;PRS	mi²+ɁmaɁ¹³	mi²+ɁmaɁ
dsiog¹²	V;IPFV;2;PRS	dsiog³	dsiog¹
kienɁ¹²	V;IPFV;2;PRS	kienɁ¹³	kienɁ¹
ɁløaɁ¹²	V;IPFV;2;PRS	ɁløaɁ³	ɁløaɁ²
Ɂiá¹²	V;IPFV;2;PRS	Ɂia¹³	Ɂia¹²
héi²	V;IPFV;2;PRS	hi²	hei¹²
mi²+dsiúg²	V;IPFV;2;PRS	mi²+dsiug³	mi²+dsiu
hnia¹²	V;IPFV;2;PRS	hnia¹²	hnia¹²
hnḗ¹²	V;IPFV;2;PRS	hnē¹²	hnē¹³
ɁóɁ¹²	V;IPFV;2;PRS	ɁuanɁ¹²	ɁoɁ²Ɂ
mi²+Ɂog¹³	V;IPFV;2;PRS	mi²+Ɂog³	mi²+Ɂog³
lēɁ²	V;IPFV;2;PRS	lēɁ³	lēɁ³²
mi²+Ɂan¹³	V;IPFV;2;PRS	mi²+Ɂan¹³	mi²+Ɂan¹
bḗn²	V;IPFV;2;PRS	bēn¹²	bēn¹²
hmo¹²	V;IPFV;2;PRS	hmo²	hmo²²
mi²+hniang¹ dsǿa¹²	V;IPFV;2;PRS	mi²+hniang³	mi²+hniang³(((
ɁmíɁ²	V;IPFV;2;PRS	ɁmiɁ²	ɁmiɁ²
ɁéɁ¹²	V;IPFV;2;PRS	ɁeɁ¹²	ɁeɁ¹¹
ɁmiɁ¹²	V;IPFV;2;PRS	ɁmiɁ³	ɁmiɁ³²
nung²	V;IPFV;2;PRS	nung¹²	nung¹
kḗn²	V;IPFV;2;PRS	kēn²	kēn²²
hniuɁ²	V;IPFV;2;PRS	hniang²	hniuɁg
iaɁ¹²	V;IPFV;2;PRS	iaɁ³	iaɁ³¹
chi²+ngiú²	V;IPFV;2;PRS	chi²+ngiu³	chi²+ngi
hug²	V;IPFV;2;PRS	hug²	hug¹²
dsen¹²	V;IPFV;2;PRS	dsen¹²	dsen¹¹
tsáiɁ¹²	V;IRR;3;FUT	tsáiɁ¹	tsáiɁ¹
kø²+káng¹²	V;IRR;3;FUT	kø³+káng¹²	kø³+káng
guiágɁ¹²	V;IRR;3;FUT	guiágɁ¹	guiágɁ¹
bø²+hmé²	V;IRR;3;FUT	bø³+hmé²	bø³+hmé
ɁnóɁ¹² dsí²	V;IRR;3;FUT	ɁnóɁ¹	ɁnóɁ¹¹²2¹
dsánɁ¹²	V;IRR;3;FUT	dsiánɁ¹²	dsánɁ¹
Ɂuø¹²	V;IRR;3;FUT	Ɂuø¹	Ɂuø¹¹
guión²	V;IRR;3;FUT	guión²	guión²
lǿɁ²	V;IRR;3;FUT	líɁ²	lǿɁ²
tií²	V;IRR;3;FUT	tií²	tií²
héinɁ¹²	V;IRR;3;FUT	héinɁ¹	héinɁ¹
Ɂien¹²	V;IRR;3;FUT	Ɂien¹	Ɂien¹²
mi²+kionɁ¹	V;IRR;3;FUT	mi³+kionɁ¹	mi³+kion
hénɁ²	V;IRR;3;FUT	hénɁ²	hénɁ²
hǿɁ¹²	V;IRR;3;FUT	hǿɁ¹	hǿɁ¹²
chi²+dsán²	V;IRR;3;FUT	chi³+dsán²	chi³+dsá
mi²+dsøg¹²	V;IRR;3;FUT	mi³+dsøg¹²	mi³+dsøg
guieɁ¹²	V;IRR;3;FUT	guieɁ¹	guieɁ¹
mi²+chian¹²	V;IRR;3;FUT	mi³+chian¹²	mi³+chian
guiúg²	V;IRR;3;FUT	guiúg²	guiúg²
Ɂon¹²	V;IRR;3;FUT	Ɂon¹	Ɂon¹²
niá¹²	V;IRR;3;FUT	niá¹	niá¹²
tangɁ²	V;IRR;3;FUT	tangɁ²	tangɁ²
Ɂan¹²	V;IRR;3;FUT	Ɂan¹	Ɂan¹³
dsian¹²	V;IRR;3;FUT	dsian¹	dsian¹
heinɁ²	V;IRR;3;FUT	heinɁ¹	heinɁ²
dság¹²	V;IRR;3;FUT	dság¹	dság¹²
hmóngɁ¹²	V;IRR;3;FUT	hmóngɁ¹	hmóngɁ¹
chi²+dsí²	V;IRR;3;FUT	chi³+dsí²	chi³+dsí
tánɁ¹²	V;IRR;3;FUT	tánɁ¹³	tánɁ¹²
kuøin¹²	V;IRR;3;FUT	kuøin¹	kuøin¹
gógɁ¹²	V;IRR;3;FUT	gógɁ¹	gógɁ¹²
ɁuáiɁ¹²	V;IRR;3;FUT	ɁuáiɁ¹	ɁuáiɁ¹
mi²+hénɁ²	V;IRR;3;FUT	mi³+hénɁ²	mi³+hénɁ
ti²+líɁ¹	V;IRR;3;FUT	ti³+líɁ¹	ti³+líɁ
hánɁ¹²	V;IRR;3;FUT	hánɁ¹	hánɁ¹²
mi²+kiíngɁ²	V;IRR;3;FUT	mi³+kiíngɁ²	mi³+kiíng
tieɁ¹²	V;IRR;3;FUT	tieɁ¹	tieɁ¹²
chio¹²	V;IRR;3;FUT	chio¹	chio¹Ɂ
hinɁ³	V;IRR;3;FUT	hinɁ¹	hinɁ¹
tian¹²	V;IRR;3;FUT	tian¹	tian¹²
ngē¹²	V;IRR;3;FUT	ngē¹²	ngē¹²
lanɁ¹²	V;IRR;3;FUT	lanɁ¹	lanɁ¹²
ngái¹²	V;IRR;3;FUT	ngái¹	ngái¹²
tión²	V;IRR;3;FUT	tión²	tión²
Ɂøa¹²	V;IRR;3;FUT	Ɂøa¹	Ɂøa¹¹
hngiáɁ²	V;IRR;3;FUT	hngiáɁ²	hngiáɁ
ngioɁ¹²	V;IRR;3;FUT	ngioɁ¹²	ngioɁ¹
ngøa¹²	V;IRR;3;FUT	ngøa¹	ngøa¹²
ɁlianɁ²	V;IRR;3;FUT	ɁlianɁ¹	ɁlianɁ
køɁ¹²	V;IRR;3;FUT	køɁ¹	køɁ¹¹
hngióɁ¹²	V;IRR;3;FUT	hngióɁ¹	hngióɁ¹
se¹²	V;IRR;3;FUT	se¹	se¹³
tsǿɁ¹²	V;IRR;3;FUT	tsǿɁ¹	tsǿɁ¹²
guiú²	V;IRR;3;FUT	guiú²	guiú²
ta¹²	V;IRR;3;FUT	ta¹	ta¹³
rónɁ¹²	V;IRR;3;FUT	rónɁ¹	rónɁ¹²
kúgɁ¹²	V;IRR;3;FUT	kúgɁ¹²	kúgɁ¹²
nioɁ²	V;IRR;3;FUT	nioɁ¹	nioɁ¹
huúɁ¹²	V;IRR;3;FUT	huúɁ¹	huúɁ¹²
hḗnɁ²	V;IRR;3;FUT	hḗnɁ²	hḗnɁ²
chi²+kián²	V;IRR;3;FUT	chi³+kián²	chi³+kiá
téiɁ¹²	V;IRR;3;FUT	téiɁ¹	téiɁ¹³
lóɁ¹²	V;IRR;3;FUT	lóɁ¹	lóɁ¹²
hnḗɁ²	V;IRR;3;FUT	hnḗɁ²	hnḗɁ²
ɁóɁ²	V;IRR;3;FUT	ɁóɁ²	ɁóɁ²
ngē²	V;IRR;3;FUT	ngē²	ngē²
mi²+dsēn¹²	V;IRR;3;FUT	mi³+dsēn¹²	mi³+dsēn
tø²+ɁénɁ¹²	V;IRR;3;FUT	tø³+ɁénɁ¹	tø³+ɁénɁ
uénɁ²	V;IRR;3;FUT	uénɁ²	uénɁ²
ti²+dso¹	V;IRR;3;FUT	ti³+dso¹	ti³+dso
rón²	V;IRR;3;FUT	rón²	rón²
Ɂo¹²	V;IRR;3;FUT	Ɂo¹	Ɂo¹³
hǿɁ²	V;IRR;3;FUT	hǿɁ²	hǿɁ²
hnǿ²	V;IRR;3;FUT	hnǿ²	hnǿ²
hnaiɁ¹²	V;IRR;3;FUT	hnaiɁ¹	hnaiɁ¹
mi²+tan¹³	V;IRR;3;FUT	mi³+tan¹³	mi³+tan¹
guønɁ¹²	V;IRR;3;FUT	guønɁ¹	guønɁ¹
kán²	V;IRR;3;FUT	kán²	kán²
háinɁ¹²	V;IRR;3;FUT	háinɁ¹	háinɁ¹
dsø²+huen¹³	V;IRR;3;FUT	dsø³+huen¹³	dsø³+huen
lag²	V;IRR;3;FUT	lag¹	lag¹
huú²	V;IRR;3;FUT	huú²	huú²
bán²	V;IRR;3;FUT	bán²	bán²
mi²+tég²	V;IRR;3;FUT	mi³+tég²	mi³+tég
kiuɁ¹²	V;IRR;3;FUT	kiuɁ¹	kiuɁ¹¹
guøn¹²	V;IRR;3;FUT	guøn¹	guøn¹²
len¹²	V;IRR;3;FUT	len¹²	len¹²
rǿnɁ¹²	V;IRR;3;FUT	rǿnɁ¹	rǿnɁ¹²
gog²	V;IRR;3;FUT	gog¹	gog¹
lán¹²	V;IRR;3;FUT	lén²	lán¹²
Ɂna²	V;IRR;3;FUT	Ɂnií¹	Ɂna²
Ɂno¹²	V;IRR;3;FUT	Ɂno¹	Ɂno¹Ɂ
mi²+kien¹²	V;IRR;3;FUT	mi³+kien¹²	mi³+kien
chióɁ¹²	V;IRR;3;FUT	chióɁ¹	chióɁ¹
siúg²	V;IRR;3;FUT	siúg²	siúg²
huánɁ²	V;IRR;3;FUT	huánɁ²	huánɁ²
dsiag¹²	V;IRR;3;FUT	dsiag¹	dsiag¹
guiónɁ²	V;IRR;3;FUT	guiónɁ²	guiónɁ
mi²+kon¹²	V;IRR;3;FUT	mi³+kon¹²	mi³+kon¹
hanɁ¹² dsǿa¹²	V;IRR;3;FUT	hanɁ¹	hanɁ¹²²³¹g
ngié²	V;IRR;3;FUT	ngié²	ngié²
tsogɁ² hmøi²	V;IRR;3;FUT	tsogɁ¹	tsogɁ¹²2¹¹
ténɁ¹²	V;IRR;3;FUT	ténɁ¹	ténɁ¹³
guǿn¹²	V;IRR;3;FUT	guǿn¹	guǿn¹²
tson²	V;IRR;3;FUT	chión¹	tson²
Ɂio¹²	V;IRR;3;FUT	Ɂio¹	Ɂio¹Ɂ
hen¹²	V;IRR;3;FUT	hen¹	hen¹²
hián²	V;IRR;3;FUT	hián²	hián²
huǿin¹²	V;IRR;3;FUT	huǿin¹	huǿin¹
tsón¹²	V;IRR;3;FUT	tsón¹	tsón¹²
kii²+tág¹²	V;IRR;3;FUT	kii³+tág¹	kii³+tág
dsoɁ²	V;IRR;3;FUT	dsioɁ¹	dsoɁ²
køn¹²	V;IRR;3;FUT	køn¹	køn¹¹
Ɂiog²	V;IRR;3;FUT	Ɂiog¹	Ɂiog¹
tsog²	V;IRR;3;FUT	tsog¹	tsog¹
mi²+tsḗn¹	V;IRR;3;FUT	mi³+tsḗn¹	mi³+tsḗn
kugɁ¹²	V;IRR;3;FUT	kugɁ¹	kugɁ¹²
tsǿaɁ¹²	V;IRR;3;FUT	tsǿaɁ¹	tsǿaɁ¹
hne¹²	V;IRR;3;FUT	hne¹	hne¹¹
tsǿng²	V;IRR;3;FUT	tsǿng²	tsǿng²
ku²+hmáɁ²	V;IRR;3;FUT	ku³+hmáɁ²	ku³+hmáɁ
hág¹²	V;IRR;3;FUT	hág¹	hág¹Ɂ
hmóɁ¹²	V;IRR;3;FUT	hmóɁ¹	hmóɁ¹²
hngie¹²	V;IRR;3;FUT	hngie¹	hngie¹
húɁ²	V;IRR;3;FUT	húɁ²	húɁ²
mi²+dsiog¹	V;IRR;3;FUT	mi³+dsiog¹	mi³+dsio
Ɂnia¹²	V;IRR;3;FUT	Ɂnia¹	Ɂnia¹¹
héin¹²	V;IRR;3;FUT	héin¹	héin¹³
hleɁ¹²	V;IRR;3;FUT	hleɁ¹²	hleɁ¹²
dsúgɁ²	V;IRR;3;FUT	dsúgɁ²	dsúgɁ²
nióɁ¹²	V;IRR;3;FUT	nióɁ¹	nióɁ¹²
ngie¹²	V;IRR;3;FUT	ngie¹	ngie¹²
dsiánɁ¹²	V;IRR;3;FUT	dsiánɁ¹³	dsiánɁ¹
Ɂiag²	V;IRR;3;FUT	Ɂiag¹	Ɂiag¹
kieg²	V;IRR;3;FUT	kieg¹	kieg¹
mi²+tan¹²	V;IRR;3;FUT	mi³+tan¹²	mi³+tan¹
kióɁ¹²	V;IRR;3;FUT	kióɁ¹	kióɁ¹²
gǿaɁ¹²	V;IRR;3;FUT	gǿaɁ¹	gǿaɁ¹²
guen²	V;IRR;3;FUT	guen¹	guen²
tug	V;IRR;3;FUT	tiug¹²	tiug
hngēɁ¹²	V;IRR;3;FUT	hngēɁ¹	hngēɁ¹
hmǿɁ¹²	V;IRR;3;FUT	hmǿɁ¹	hmǿɁ¹²
tsénɁ²	V;IRR;3;FUT	tsénɁ²	tsénɁ²
chiunɁ¹²	V;IRR;3;FUT	chiunɁ¹	chiunɁ¹
tióɁ¹²	V;IRR;3;FUT	tióɁ¹	tióɁ¹²
tø²+húg³	V;IRR;3;FUT	tø³+húg³	tø³+húg
kug²	V;IRR;3;FUT	kug¹	kug¹
tsēn¹²	V;IRR;3;FUT	tsēn¹	tsēn¹²
mi²+Ɂlí¹	V;IRR;3;FUT	mi³+Ɂlí¹	mi³+Ɂlí
niúɁ²	V;IRR;3;FUT	niúɁ²	niúɁ²
dsen³ (kaɁ³)	V;IRR;3;FUT	dsen³	dsen³Ɂi²²²
chiogɁ¹²	V;IRR;3;FUT	chiogɁ¹	chiogɁ¹
chi²+méɁ²	V;IRR;3;FUT	chi³+méɁ²	chi³+méɁ
chi²+lánɁ²	V;IRR;3;FUT	chi³+lánɁ²	chi³+lán
Ɂén²	V;IRR;3;FUT	Ɂén²	Ɂén²
hánɁ²	V;IRR;3;FUT	hánɁ²	hánɁ²
tsø²+kuønɁ¹²	V;IRR;3;FUT	tsø³+kuønɁ¹²	tsø³+kuønɁ
uǿi²	V;IRR;3;FUT	uǿi²	uǿi²
mi²+kuuɁ¹²	V;IRR;3;FUT	mi³+kuuɁ¹²	mi³+kuuɁ
tø²+gugɁ¹²	V;IRR;3;FUT	tø³+gugɁ¹²	tø³+gugɁ
mi²+níɁ¹	V;IRR;3;FUT	mi³+níɁ¹	mi³+níɁ
búɁ²	V;IRR;3;FUT	búɁ²	búɁ²
køɁ³ (hmai³)	V;IRR;3;FUT	køɁ³	køɁ³¹Ɂ²²n²
Ɂiei¹²	V;IRR;3;FUT	Ɂiei¹	Ɂiei¹²
hngiángɁ¹²	V;IRR;3;FUT	hngiángɁ¹	hngiángɁ
kién¹²	V;IRR;3;FUT	kién¹	kién¹²
hḗn²	V;IRR;3;FUT	hḗn²	hḗn²
ngai¹²	V;IRR;3;FUT	ngai¹	ngai¹²
chión²	V;IRR;3;FUT	chión²	chión²
hmḗɁ²	V;IRR;3;FUT	hmḗɁ²	hmḗɁ²
Ɂiog¹²	V;IRR;3;FUT	Ɂiog¹	Ɂiog¹²
dsiég¹²	V;IRR;3;FUT	dsiég¹³	dsiég¹
mi²+dsíg²	V;IRR;3;FUT	mi³+dsíg²	mi³+dsíg
tǿɁ²	V;IRR;3;FUT	tǿɁ²	tǿɁ²
hnáɁ²	V;IRR;3;FUT	hnáɁ²	hnáɁ²
lieɁ¹²	V;IRR;3;FUT	lieɁ¹	lieɁ¹²
ɁiéiɁ¹²	V;IRR;3;FUT	ɁiéiɁ¹	ɁiéiɁ¹
ti²+dsǿ²	V;IRR;3;FUT	ti³+dsǿ²	ti³+dsǿ
káiɁ¹²	V;IRR;3;FUT	káiɁ¹	káiɁ¹²
chi²+hné¹	V;IRR;3;FUT	chi³+hné¹	chi³+hné
guen¹²	V;IRR;3;FUT	guen¹	guen¹²
mi²+hǿ²	V;IRR;3;FUT	mi³+hǿ²	mi³+hǿ
hmáɁ² (dsǿa¹²)	V;IRR;3;FUT	hmáɁ²	hmáɁ²²¹²²²²
tónɁ² (huu¹²)	V;IRR;3;FUT	tónɁ²	tónɁ²Ɂ²²²²
li²	V;IRR;3;FUT	li¹	li²¹
kēnɁ¹²	V;IRR;3;FUT	kēnɁ¹²	kēnɁ¹²
dsióɁ¹²	V;IRR;3;FUT	dsióɁ¹	dsióɁ¹
tsiɁ¹²	V;IRR;3;FUT	tsiɁ¹	tsiɁ¹²
kiéɁ¹²	V;IRR;3;FUT	kiéɁ¹	kiéɁ¹²
bén²	V;IRR;3;FUT	bén²	bén²
hlái²	V;IRR;3;FUT	hlái²	hlái²
héɁ²	V;IRR;3;FUT	héɁ²	héɁ²
ngiú²	V;IRR;3;FUT	ngiú²	ngiú²
lúg²	V;IRR;3;FUT	liúg²	lúg²
ɁiánɁ²	V;IRR;3;FUT	ɁiánɁ²	ɁiánɁ²
mi²+Ɂai¹	V;IRR;3;FUT	mi³+Ɂai¹	mi³+Ɂai
kiog¹²	V;IRR;3;FUT	kiog¹²	kiog¹²
dsan²	V;IRR;3;FUT	dsián¹	dsan²
hmáɁ² (ta³)	V;IRR;3;FUT	hmáɁ²	hmáɁ²²¹²¹
tiun¹²	V;IRR;3;FUT	tiun¹	tiun¹¹
lø²+liúɁ²	V;IRR;3;FUT	lø³+liúɁ²	lø³+liúɁ
dsǿɁ²	V;IRR;3;FUT	dsǿɁ²	dsǿɁ²
guian¹²	V;IRR;3;FUT	guian¹	guian¹
ti²+li¹	V;IRR;3;FUT	ti³+li¹	ti³+li
mi²+ngḗɁ¹	V;IRR;3;FUT	mi³+ngḗɁ¹	mi³+ngḗɁ
guiúnɁ¹²	V;IRR;3;FUT	guiúnɁ¹	guiúnɁ¹
mi²+kuen¹²	V;IRR;3;FUT	mi³+kuen¹²	mi³+kuen
mi²+gǿg¹	V;IRR;3;FUT	mi³+gǿg¹	mi³+gǿg
kanɁ¹²	V;IRR;3;FUT	kanɁ¹	kanɁ¹²
hnó²	V;IRR;3;FUT	hnó²	hnó²
liág¹	V;IRR;3;FUT	liág¹	liág¹
Ɂǿng²	V;IRR;3;FUT	Ɂǿng²	Ɂǿng²
Ɂnē¹²	V;IRR;3;FUT	Ɂnē¹	Ɂnē¹²
hlég²	V;IRR;3;FUT	hlég²	hlég²
dsii²+lian¹	V;IRR;3;FUT	dsii³+lian¹	dsii³+lia
hné¹²	V;IRR;3;FUT	hné¹	hné¹²
gǿi¹²	V;IRR;3;FUT	gǿi¹	gǿi¹²
tsón²	V;IRR;3;FUT	tsón²	tsón²
chiog¹²	V;IRR;3;FUT	chiog¹	chiog¹
húgɁ²	V;IRR;3;FUT	húgɁ²	húgɁ²
mái¹²	V;IRR;3;FUT	mái¹	mái¹²
kiáɁ²	V;IRR;3;FUT	kiáɁ²	kiáɁ²
dsogɁ¹²	V;IRR;3;FUT	dsogɁ¹	dsogɁ¹
hiugɁ¹²	V;IRR;3;FUT	hiugɁ¹	hiugɁ¹
kian¹²	V;IRR;3;FUT	kian¹	kian¹²
Ɂngiéng¹²	V;IRR;3;FUT	Ɂngiéng¹	Ɂngiéng¹
tián²	V;IRR;3;FUT	tián²	tián²
tso¹²	V;IRR;3;FUT	tso¹	tso¹n
siég²	V;IRR;3;FUT	siég²	siég²
sianɁ¹²	V;IRR;3;FUT	sianɁ¹	sianɁ¹
kien¹²	V;IRR;3;FUT	kien¹	kien¹²
Ɂuu²	V;IRR;3;FUT	Ɂuu¹	Ɂuu²
búɁ¹²	V;IRR;3;FUT	búɁ¹	búɁ¹²
ngēɁ² dsǿa¹²	V;IRR;3;FUT	ngēɁ¹	ngēɁ¹¹²2¹²
mi²+hniang¹ ni³	V;IRR;3;FUT	mi³+hniang¹	mi³+hniang¹
mi²+guionɁ¹	V;IRR;3;FUT	mi³+guionɁ¹	mi³+guion
tagɁ²	V;IRR;3;FUT	tagɁ¹	tagɁ²
kúgɁ²	V;IRR;3;FUT	kúgɁ²	kúgɁ²
ɁngióɁ¹²	V;IRR;3;FUT	ɁngióɁ¹	ɁngióɁ¹
Ɂma¹²	V;IRR;3;FUT	Ɂma¹	Ɂma¹g
hiégɁ¹²	V;IRR;3;FUT	hiégɁ¹	hiégɁ¹
ɁiúɁ²	V;IRR;3;FUT	ɁiúɁ²	ɁiúɁ²
tóɁ¹²	V;IRR;3;FUT	tóɁ¹	tóɁ¹³
tanɁ¹² huu¹²	V;IRR;3;FUT	tanɁ¹²	tanɁ¹²i³¹¹
kán² guiing²	V;IRR;3;FUT	kán²	kán²²²²³Ɂ(
Ɂug¹²	V;IRR;3;FUT	Ɂug¹	Ɂug¹¹
ián²	V;IRR;3;FUT	ián²	ián²
hén²	V;IRR;3;FUT	hén²	hén²
mi²+Ɂan¹²	V;IRR;3;FUT	mi³+Ɂan¹²	mi³+Ɂan¹
dsēn¹²	V;IRR;3;FUT	dsēn¹	dsēn¹Ɂ
hiúgɁ²	V;IRR;3;FUT	hiúgɁ²	hiúgɁ²
hngieng¹²	V;IRR;3;FUT	hngieng¹	hngieng¹
lá¹²	V;IRR;3;FUT	lá¹	lá¹³
Ɂø²+tsúgɁ²	V;IRR;3;FUT	Ɂø³+tsúgɁ²	Ɂø³+tsúg
Ɂéi¹²	V;IRR;3;FUT	Ɂéi¹	Ɂéi¹²
mi²+kiín¹	V;IRR;3;FUT	mi³+kiín¹	mi³+kiín
ié²	V;IRR;3;FUT	ié²	ié²²
hønɁ¹²	V;IRR;3;FUT	hønɁ¹	hønɁ¹²
tsøi¹²	V;IRR;3;FUT	tsøi¹	tsøi¹²
gúg²	V;IRR;3;FUT	gúg²	gúg²
kuǿɁ¹²	V;IRR;3;FUT	kuǿɁ¹	kuǿɁ¹²
Ɂuǿi²	V;IRR;3;FUT	Ɂuǿi²	Ɂuǿi²
taɁ²	V;IRR;3;FUT	tiíɁ¹	taɁ²
tiánɁ¹²	V;IRR;3;FUT	tiánɁ¹	tiánɁ¹
tsenɁ¹²	V;IRR;3;FUT	tsenɁ¹	tsenɁ¹
Ɂe¹²	V;IRR;3;FUT	Ɂe¹	Ɂe¹³
mi²+kiónɁ²	V;IRR;3;FUT	mi³+kiónɁ²	mi³+kión
lio¹²	V;IRR;3;FUT	lio¹	lio¹²
ɁmóɁ²	V;IRR;3;FUT	ɁmóɁ²	ɁmóɁ²
sián²	V;IRR;3;FUT	sián²	sián²
tian¹	V;IRR;3;FUT	tian¹	tian¹
dsii²+lei¹	V;IRR;3;FUT	dsii³+lei¹	dsii³+le
mi²+kán¹²	V;IRR;3;FUT	mi³+kán¹²	mi³+kán¹
guiugɁ²	V;IRR;3;FUT	guiugɁ¹	guiugɁ
ɁmēɁ¹²	V;IRR;3;FUT	ɁmēɁ¹	ɁmēɁ¹²
mi²+hní¹	V;IRR;3;FUT	mi³+hní¹	mi³+hní
hngióɁ²	V;IRR;3;FUT	hngióɁ²	hngióɁ
ɁenɁ¹²	V;IRR;3;FUT	ɁenɁ¹	ɁenɁ¹²
Ɂig²	V;IRR;3;FUT	Ɂig¹	Ɂig¹
tsēnɁ¹²	V;IRR;3;FUT	tsenɁ¹²	tsēnɁ¹
kang²	V;IRR;3;FUT	kang¹	kang¹
liúg²	V;IRR;3;FUT	liúg²	liúg²
ngǿi²	V;IRR;3;FUT	ngǿi²	ngǿi²
togɁ¹²	V;IRR;3;FUT	togɁ¹²	togɁ¹²
siógɁ¹²	V;IRR;3;FUT	siógɁ¹	siógɁ¹
guenɁ¹²	V;IRR;3;FUT	guenɁ¹	guenɁ¹
hénɁ¹²	V;IRR;3;FUT	hénɁ¹³	hénɁ¹³
siúgɁ²	V;IRR;3;FUT	siúgɁ²	siúgɁ²
Ɂen¹²	V;IRR;3;FUT	Ɂen¹	Ɂen¹²
hnáɁ¹²	V;IRR;3;FUT	hnáɁ¹	hnáɁ¹²
lánɁ²	V;IRR;3;FUT	lánɁ²	lánɁ²
Ɂnie¹²	V;IRR;3;FUT	Ɂnie¹	Ɂnie¹²
ngie³	V;IRR;3;FUT	ngie¹	ngie¹
ngieɁ¹³	V;IRR;3;FUT	ngieɁ¹³	ngieɁ¹
tsøg²	V;IRR;3;FUT	tsøg¹	tsøg¹
lióg¹²	V;IRR;3;FUT	lióg¹	lióg¹²
dságɁ¹²	V;IRR;3;FUT	dsiágɁ¹	dságɁ¹
Ɂian²	V;IRR;3;FUT	Ɂian¹	Ɂian²
Ɂnai¹²	V;IRR;3;FUT	Ɂnai¹²	Ɂnai¹²
guienɁ¹²	V;IRR;3;FUT	guienɁ¹	guienɁ¹
hngió²	V;IRR;3;FUT	hngió²	hngió²
kiugɁ²	V;IRR;3;FUT	kiugɁ¹	kiugɁ²
chióg¹²	V;IRR;3;FUT	chióg¹	chióg¹
Ɂme¹²	V;IRR;3;FUT	Ɂme¹	Ɂme¹g
Ɂmóng¹²	V;IRR;3;FUT	Ɂmóng¹	Ɂmóng¹
mi²+hu¹	V;IRR;3;FUT	mi³+hu¹	mi³+hu
Ɂog¹²	V;IRR;3;FUT	Ɂog¹	Ɂog¹²
kø¹²	V;IRR;3;FUT	kø¹	kø¹³
Ɂia¹²	V;IRR;3;FUT	Ɂia¹	Ɂia¹¹
u¹+lian¹	V;IRR;3;FUT	u³+lian¹	u³+lian
kógɁ¹²	V;IRR;3;FUT	kógɁ¹	kógɁ¹²
dsan¹²	V;IRR;3;FUT	dsan¹	dsan¹²
hlø²	V;IRR;3;FUT	hlé¹	hlø²
guø¹²	V;IRR;3;FUT	guø¹	guø¹¹
Ɂian¹²	V;IRR;3;FUT	Ɂian¹²	Ɂian¹²
tø²+dsḗn³	V;IRR;3;FUT	tø³+dsḗn³	tø³+dsḗn
mi²+dsian¹²	V;IRR;3;FUT	mi³+dsian¹²	mi³+dsian
kiang¹²	V;IRR;3;FUT	kiang¹	kiang¹
chiúg²	V;IRR;3;FUT	chiúg²	chiúg²
ɁánɁ²	V;IRR;3;FUT	ɁánɁ²	ɁánɁ²
tiúg²	V;IRR;3;FUT	tiúg²	tiúg²
guu²+dsḗn¹³	V;IRR;3;FUT	guu³+dsḗn¹³	guu³+dsḗn
guiánɁ¹²	V;IRR;3;FUT	guiánɁ¹	guiánɁ¹
Ɂein¹³	V;IRR;3;FUT	Ɂein¹³	Ɂein¹³
hniá¹²	V;IRR;3;FUT	hniá¹	hniá¹Ɂ
séi²	V;IRR;3;FUT	séi²	séi²
Ɂlan¹²	V;IRR;3;FUT	Ɂlan¹	Ɂlan¹²
ngoɁ³	V;IRR;3;FUT	ngoɁ¹	ngoɁ¹
hog¹²	V;IRR;3;FUT	hog¹	hog¹Ɂ
køgɁ²	V;IRR;3;FUT	køgɁ¹	køgɁ¹
lan²	V;IRR;3;FUT	len¹	lan²
ɁénɁ¹²	V;IRR;3;FUT	ɁénɁ¹³	ɁénɁ¹³
ha²+lei¹	V;IRR;3;FUT	ha³+lig2¹	ha³+lig
guiang¹²	V;IRR;3;FUT	guiang¹	guiang¹
kuan¹²	V;IRR;3;FUT	kuan¹	kuan¹²
Ɂngiéng²	V;IRR;3;FUT	Ɂngiéng²	Ɂngiéng
siog²	V;IRR;3;FUT	siog¹	siog¹
gúgɁ¹² dsǿa¹²	V;IRR;3;FUT	gúgɁ¹	gúgɁ¹²¹¹²²
guiég¹²	V;IRR;3;FUT	guiég¹	guiég¹
huu¹²	V;IRR;3;FUT	huu¹	huu¹²
tsíɁ¹²	V;IRR;3;FUT	tsíɁ¹	tsíɁ¹²
hí²	V;IRR;3;FUT	hí²	hí²¹
Ɂéng²	V;IRR;3;FUT	Ɂéng²	Ɂéng²
tan¹³	V;IRR;3;FUT	tan¹³	tan¹³
ɁlíɁ¹²	V;IRR;3;FUT	ɁlíɁ¹	ɁlíɁ¹²
ku²+guénɁ²	V;IRR;3;FUT	ku³+guénɁ²	ku³+guén
hnéi¹²	V;IRR;3;FUT	hnéi¹	hnéi¹²
koɁ¹²	V;IRR;3;FUT	koɁ¹	koɁ¹³
gúɁ¹²	V;IRR;3;FUT	gúɁ¹	gúɁ¹²
kánɁ¹²	V;IRR;3;FUT	kánɁ¹²	kánɁ¹²
kionɁ¹²	V;IRR;3;FUT	kionɁ¹³	kionɁ¹
bēn¹²	V;IRR;3;FUT	bēn¹	bēn¹Ɂ
Ɂai¹²	V;IRR;3;FUT	Ɂai¹	Ɂai¹³
dsi²	V;IRR;3;FUT	dsi¹	dsi¹
mi²+dsiagɁ¹	V;IRR;3;FUT	mi³+dsiagɁ¹	mi³+dsiag
téng²	V;IRR;3;FUT	téng²	téng²
mi²+ti¹	V;IRR;3;FUT	mi³+ti¹	mi³+ti
chionɁ¹²	V;IRR;3;FUT	chionɁ¹	chionɁ¹
ngēɁ²	V;IRR;3;FUT	ngēɁ¹	ngēɁ²
mi²+lei¹³	V;IRR;3;FUT	mi³+lei¹³	mi³+lei¹
tógɁ¹²	V;IRR;3;FUT	tógɁ¹	tógɁ¹²
dsanɁ¹²	V;IRR;3;FUT	dsianɁ¹²	dsanɁ¹
téiɁ²	V;IRR;3;FUT	téiɁ²	téiɁ²
neɁ¹²	V;IRR;3;FUT	neɁ¹	neɁ¹¹
hógɁ¹²	V;IRR;3;FUT	hiúgɁ²	hógɁ¹²
tei²	V;IRR;3;FUT	tei¹	tei²
kuø¹²	V;IRR;3;FUT	kuø¹	kuø¹¹
kián²	V;IRR;3;FUT	kián²	kián²
hiúɁ²	V;IRR;3;FUT	hiúɁ²	hiúɁ²
mi²+huanɁ¹²	V;IRR;3;FUT	mi³+huanɁ¹²	mi³+huanɁ
ɁiúɁ¹²	V;IRR;3;FUT	ɁiúɁ¹	ɁiúɁ¹²
hlíɁ²	V;IRR;3;FUT	hlíɁ²	hlíɁ²
kiiɁ²	V;IRR;3;FUT	kiiɁ¹	kiiɁ¹
hlǿ²	V;IRR;3;FUT	hlǿ²	hlǿ²
tan¹²	V;IRR;3;FUT	tan¹	tan¹²
ko¹²	V;IRR;3;FUT	ko¹	ko¹³
ti²+dsøa¹²	V;IRR;3;FUT	ti³+dsøa¹²	ti³+dsøa
len¹² dsǿa¹²	V;IRR;3;FUT	len¹	len¹¹Ɂ¹²¹²
tiu¹²	V;IRR;3;FUT	tiu¹	tiu¹²
tson¹²	V;IRR;3;FUT	tson¹	tson¹²
han¹²	V;IRR;3;FUT	han¹	han¹Ɂ
dsióɁ¹² hǿg³	V;IRR;3;FUT	dsióɁ¹	dsióɁ¹²¹²²
chi²+láɁ²	V;IRR;3;FUT	chi³+láɁ²	chi³+láɁ
hai¹²	V;IRR;3;FUT	hai¹	hai¹Ɂ
ngángɁ¹²	V;IRR;3;FUT	dságɁ¹	ngángɁ¹
Ɂen¹³	V;IRR;3;FUT	Ɂen¹³	Ɂen¹³
tanɁ¹²	V;IRR;3;FUT	tanɁ¹²	tanɁ¹²
gøi²	V;IRR;3;FUT	guiéi¹	gøi¹
siúɁ²	V;IRR;3;FUT	siúɁ²	siúɁ²
ɁnangɁ²	V;IRR;3;FUT	ɁnangɁ¹	ɁnangɁ
hlian¹²	V;IRR;3;FUT	hlian¹	hlian¹
tion¹²	V;IRR;3;FUT	tion¹	tion¹²
ɁáiɁ¹²	V;IRR;3;FUT	ɁáiɁ¹	ɁáiɁ¹²
hlénɁ²	V;IRR;3;FUT	hlénɁ²	hlénɁ²
Ɂø²+tsóɁ¹²	V;IRR;3;FUT	Ɂø³+tsóɁ¹	Ɂø³+tsóɁ
laiɁ¹²	V;IRR;3;FUT	laiɁ¹²	laiɁ¹²
nøɁ¹²	V;IRR;3;FUT	nøɁ¹	nøɁ¹¹
Ɂlí²	V;IRR;3;FUT	Ɂlí²	Ɂlí²
húg²	V;IRR;3;FUT	húg²	húg²
neng²	V;IRR;3;FUT	neng¹	neng¹
mi²+ɁmaɁ¹³	V;IRR;3;FUT	mi³+ɁmaɁ¹³	mi³+ɁmaɁ
siág¹²	V;IRR;3;FUT	siág¹	siág¹²
Ɂlen¹²	V;IRR;3;FUT	Ɂlen¹	Ɂlen¹²
ɁoɁ¹²	V;IRR;3;FUT	ɁoɁ¹	ɁoɁ¹³
dsiog¹²	V;IRR;3;FUT	dsiog¹	dsiog¹
mi²+hog¹²	V;IRR;3;FUT	mi³+hog¹²	mi³+hog¹
nio²	V;IRR;3;FUT	nio¹	nio²
ɁløaɁ¹²	V;IRR;3;FUT	ɁløaɁ¹	ɁløaɁ¹
ɁniɁ¹²	V;IRR;3;FUT	ɁniɁ¹	ɁniɁ¹²
dsúgɁ¹²	V;IRR;3;FUT	dsúgɁ¹	dsúgɁ¹
héi²	V;IRR;3;FUT	héi²	héi²
mi²+dsiúg²	V;IRR;3;FUT	mi³+dsiúg²	mi³+dsiú
hnia¹²	V;IRR;3;FUT	hnia¹	hnia¹¹
hnḗ¹²	V;IRR;3;FUT	hnḗ¹	hnḗ¹²
ɁóɁ¹²	V;IRR;3;FUT	ɁóɁ¹³	ɁóɁ¹³
mi²+tián² (dsǿa¹²)	V;IRR;3;FUT	mi³+tián²	mi³+tián²²¹²(
tsǿn²	V;IRR;3;FUT	tsǿn²	tsǿn²
u²+nio¹³	V;IRR;3;FUT	u³+nio¹³	u³+nio¹
laɁ¹²	V;IRR;3;FUT	laɁ¹	laɁ¹³
øg¹²	V;IRR;3;FUT	øg¹	øg¹³
lēɁ²	V;IRR;3;FUT	lēɁ²	lēɁ²
hngio¹²	V;IRR;3;FUT	hngio¹	hngio¹
tsø²+nióɁ²	V;IRR;3;FUT	tsø³+nióɁ²	tsø³+nió
mi²+Ɂan¹³	V;IRR;3;FUT	mi³+Ɂan¹³	mi³+Ɂan¹
siiɁ²	V;IRR;3;FUT	siiɁ¹	siiɁ¹
kuú²	V;IRR;3;FUT	kuú²	kuú²
hagɁ²	V;IRR;3;FUT	hiágɁ¹	hagɁ¹
bá²	V;IRR;3;FUT	bá²	bá²²
kon¹²	V;IRR;3;FUT	kon¹	kon¹²
bḗn²	V;IRR;3;FUT	bḗn²	bḗn²
hmo¹²	V;IRR;3;FUT	hmo¹	hmo¹Ɂ
siúgɁ¹²	V;IRR;3;FUT	siúgɁ¹	siúgɁ¹
mi²+hniang¹ dsǿa¹²	V;IRR;3;FUT	mi³+hniang¹	mi³+hniang¹²(
huánɁ¹²	V;IRR;3;FUT	huánɁ¹²	huánɁ¹
ɁuanɁ¹²	V;IRR;3;FUT	ɁuanɁ¹²	ɁuanɁ¹
chiú²	V;IRR;3;FUT	chiú²	chiú²
kǿg²	V;IRR;3;FUT	kiég²	kǿg²
hágɁ¹²	V;IRR;3;FUT	hiágɁ²	hágɁ¹²
Ɂlǿg²	V;IRR;3;FUT	Ɂlǿg²	Ɂlǿg²
uøin²	V;IRR;3;FUT	uøin¹	uøin¹
hínɁ¹²	V;IRR;3;FUT	hínɁ¹	hínɁ¹²
Ɂēn¹²	V;IRR;3;FUT	Ɂēn¹	Ɂēn¹²
tagɁ¹²	V;IRR;3;FUT	tagɁ¹²	tagɁ¹²
ti²+kiín¹	V;IRR;3;FUT	ti³+kiín¹	ti³+kiín
ɁéɁ¹²	V;IRR;3;FUT	ɁéɁ¹	ɁéɁ¹²
ɁagɁ²	V;IRR;3;FUT	ɁagɁ¹	ɁagɁ¹
ning²	V;IRR;3;FUT	ning¹	ning¹
guiúɁ¹²	V;IRR;3;FUT	guiúɁ¹	guiúɁ¹
kuúɁ²	V;IRR;3;FUT	kuúɁ²	kuúɁ²
høg²	V;IRR;3;FUT	hiég¹	høgg
Ɂei¹²	V;IRR;3;FUT	Ɂai¹	Ɂei¹²
mi²+ténɁ²	V;IRR;3;FUT	mi³+ténɁ²	mi³+ténɁ
tøa¹²	V;IRR;3;FUT	tøa¹	tøa¹¹
háng¹²	V;IRR;3;FUT	háng¹	háng¹²
nung²	V;IRR;3;FUT	nung¹	nung¹
kḗn²	V;IRR;3;FUT	kḗn¹	kḗn²
hní²	V;IRR;3;FUT	hní¹	hní²
kángɁ¹²	V;IRR;3;FUT	kángɁ¹	kángɁ¹
hnái¹²	V;IRR;3;FUT	hnái¹	hnái¹²
hniuɁ²	V;IRR;3;FUT	hniuɁ¹	hniuɁ¹
há¹²	V;IRR;3;FUT	há¹³	há¹³
héin²	V;IRR;3;FUT	héin²	héin²
iaɁ¹²	V;IRR;3;FUT	iaɁ¹	iaɁ¹¹
dsǿgɁ¹²	V;IRR;3;FUT	dsǿgɁ¹	dsǿgɁ¹
u²+lé²	V;IRR;3;FUT	u³+lé²	u³+lé²
u²+Ɂai¹²	V;IRR;3;FUT	u³+Ɂai¹	u³+Ɂai¹
táiɁ¹²	V;IRR;3;FUT	táiɁ¹	táiɁ¹²
ha²+lig²	V;IRR;3;FUT	ha³+lig²	ha³+lig
ngo²	V;IRR;3;FUT	ngo¹	ngo²
niu¹²	V;IRR;3;FUT	niu¹	niu¹¹
dséi¹²	V;IRR;3;FUT	dséi¹³	dséi¹³
tiúɁ¹	V;IRR;3;FUT	tiúɁ¹	tiúɁ¹
køg²	V;IRR;3;FUT	kiég¹	køgg
goɁ²	V;IRR;3;FUT	goɁ¹	goɁ¹
lǿ²	V;IRR;3;FUT	lé²	lǿ²g
gug¹²	V;IRR;3;FUT	gug¹	gug¹¹
hnøa¹²	V;IRR;3;FUT	hnøa¹	hnøa¹²
ha²+rǿng²	V;IRR;3;FUT	ha³+rǿng²	ha³+rǿng
ɁuøɁ¹²	V;IRR;3;FUT	ɁuøɁ¹²	ɁuøɁ¹²
hug²	V;IRR;3;FUT	hiúg¹	hug²
ɁuénɁ²	V;IRR;3;FUT	ɁuénɁ²	ɁuénɁ²
ha²+kién¹³	V;IRR;3;FUT	ha³+kién¹³	ha³+kién
ɁḗɁ²	V;IRR;3;FUT	ɁḗɁ²	ɁḗɁ²
huøi²	V;IRR;3;FUT	huøi¹	huøi¹
Ɂuán²	V;IRR;3;FUT	Ɂuán²	Ɂuán²
dsii²+lé²	V;IRR;3;FUT	dsii³+lé²	dsii³+lé
Ɂii²	V;IRR;3;FUT	Ɂii¹	Ɂii¹
henɁ²	V;IRR;3;FUT	henɁ¹	henɁ²
siog¹²	V;IRR;3;FUT	siog¹	siog¹²
uǿnɁ²	V;IRR;3;FUT	uǿnɁ²	uǿnɁ²
dsøɁ¹²	V;IRR;3;FUT	dsøɁ¹²	dsøɁ¹²
niɁ³	V;IRR;3;FUT	niɁ¹	niɁ¹
siánɁ²	V;IRR;3;FUT	siánɁ²	siánɁ²
hínɁ²	V;IRR;3;FUT	hínɁ²	hínɁ²
Ɂuøi¹²	V;IRR;3;FUT	Ɂuøi¹²	Ɂuøi¹²
ɁéiɁ¹²	V;IRR;3;FUT	ɁéiɁ¹³	ɁéiɁ¹³
hnáiɁ²	V;IRR;3;FUT	hnáiɁ²	hnáiɁ²
tsáiɁ¹²	V;IPFV;PL;1;PRS	tseiɁ¹²	tsaiɁ¹²
kø²+káng¹²	V;IPFV;PL;1;PRS	kø²+kang¹²	kø²+kang¹
guiágɁ¹²	V;IPFV;PL;1;PRS	guiagɁ¹²	guiagɁ¹
bø²+hmé²	V;IPFV;PL;1;PRS	bø²+hme²	bø²+hme
ɁnóɁ¹² dsí²	V;IPFV;PL;1;PRS	ɁnoɁ¹²	ɁnoɁ¹²²²³
dsánɁ¹²	V;IPFV;PL;1;PRS	dsanɁ¹²	dsanɁ¹²
guión²	V;IPFV;PL;1;PRS	guion³	guion³
lǿɁ²	V;IPFV;PL;1;PRS	løɁ²	løɁ¹
tií²	V;IPFV;PL;1;PRS	tii¹²	tii²
héinɁ¹²	V;IPFV;PL;1;PRS	heinɁ³	heinɁ¹²
Ɂien¹²	V;IPFV;PL;1;PRS	Ɂien¹²	Ɂien¹²
mi²+kionɁ¹	V;IPFV;PL;1;PRS	mi²+kionɁ¹³	mi²+kionɁ
hénɁ²	V;IPFV;PL;1;PRS	henɁ³	henɁ¹
hǿɁ¹²	V;IPFV;PL;1;PRS	høɁ¹²	høɁ¹²
chi²+dsán²	V;IPFV;PL;1;PRS	chi²+dsan¹²	chi²+dsan
mi²+dsøg¹²	V;IPFV;PL;1;PRS	mi²+dsøg¹³	mi²+dsøg¹
guieɁ¹²	V;IPFV;PL;1;PRS	guieɁ²	guieɁ²²
mi²+chian¹²	V;IPFV;PL;1;PRS	mi²+chian³	mi²+chian
guiúg²	V;IPFV;PL;1;PRS	guiug³	guiug³
niá¹²	V;IPFV;PL;1;PRS	nia¹²	nia¹²
tangɁ²	V;IPFV;PL;1;PRS	tiangɁ²	tangɁ²
Ɂan¹²	V;IPFV;PL;1;PRS	Ɂan¹²	Ɂan¹²
dsian¹²	V;IPFV;PL;1;PRS	dsian¹²	dsian¹²
dság¹²	V;IPFV;PL;1;PRS	nei²	dsag¹¹
hmóngɁ¹²	V;IPFV;PL;1;PRS	hmongɁ²	hmongɁ²
chi²+dsí²	V;IPFV;PL;1;PRS	chi²+dsi³	chi²+dsi
tsanɁ¹²	V;IPFV;PL;1;PRS	huanɁ³	tsanɁ¹²
tánɁ¹²	V;IPFV;PL;1;PRS	tanɁ¹²	tanɁ¹²
gógɁ¹²	V;IPFV;PL;1;PRS	gogɁ¹²	gogɁ¹²
mi²+hénɁ²	V;IPFV;PL;1;PRS	mi²+henɁ³	mi²+henɁ
ti²+líɁ¹	V;IPFV;PL;1;PRS	ti²+liɁ¹	ti²+liɁ
mi²+kiíngɁ²	V;IPFV;PL;1;PRS	mi²+kiingɁ³	mi²+kiing
ɁúgɁ²	V;IPFV;PL;1;PRS	ɁogɁ³	ɁugɁ³
hiúg²	V;IPFV;PL;1;PRS	hiug³	hiug²
chio¹²	V;IPFV;PL;1;PRS	chieg²	chio¹²
tian¹²	V;IPFV;PL;1;PRS	tian¹²	tian¹²
mi²+hmḗ²	V;IPFV;PL;1;PRS	mi²+hmē³	mi²+hmē
ngē¹²	V;IPFV;PL;1;PRS	ngē¹³	ngē¹²
lanɁ¹²	V;IPFV;PL;1;PRS	lanɁ¹²	lanɁ¹²
ngái¹²	V;IPFV;PL;1;PRS	ngai³	ngai³²
tión²	V;IPFV;PL;1;PRS	tion³	tion³
tsø²+kuenɁ¹²	V;IPFV;PL;1;PRS	tsø²+kuenɁ¹²	tsø²+kuenɁ
Ɂøa¹²	V;IPFV;PL;1;PRS	Ɂi²	Ɂia²²
hngiáɁ²	V;IPFV;PL;1;PRS	hngiaɁ¹²	hngiaɁ¹
ngioɁ¹²	V;IPFV;PL;1;PRS	ngioɁ²	ngioɁ²¹
ngøa¹²	V;IPFV;PL;1;PRS	ngøa²	ngøa¹³
ɁlianɁ²	V;IPFV;PL;1;PRS	ɁlianɁ²	ɁlianɁ²
hngióɁ¹²	V;IPFV;PL;1;PRS	hngioɁ¹³	hngioɁ¹
se¹²	V;IPFV;PL;1;PRS	se¹²	se²²
tsǿɁ¹²	V;IPFV;PL;1;PRS	tsøɁ¹²	tsøɁ¹²
ta¹²	V;IPFV;PL;1;PRS	ta²	ta²²
kúgɁ¹²	V;IPFV;PL;1;PRS	kiugɁ¹²	kugɁ¹²
nioɁ²	V;IPFV;PL;1;PRS	nioɁ²	nioɁ²
kágɁ¹²	V;IPFV;PL;1;PRS	kagɁ³	kagɁ¹²
mi²+hnia¹²	V;IPFV;PL;1;PRS	mi²+hnia¹³	mi²+hnia¹
hian¹²	V;IPFV;PL;1;PRS	hian¹²	hian¹²
ku² hmo¹²	V;IPFV;PL;1;PRS	ku²	ku²²Ɂ²¹¹
kión²	V;IPFV;PL;1;PRS	kion³	kion³
téiɁ¹²	V;IPFV;PL;1;PRS	teiɁ²	teiɁ¹²
hnḗɁ²	V;IPFV;PL;1;PRS	hnēɁ³	hnēɁ³
ɁóɁ²	V;IPFV;PL;1;PRS	ɁoɁ¹²	ɁoɁ¹
ngē²	V;IPFV;PL;1;PRS	ngē²	ngē¹
mi²+ɁḗɁ²	V;IPFV;PL;1;PRS	mi²+ɁēɁ³	mi²+ɁēɁ
tø²+ɁénɁ¹²	V;IPFV;PL;1;PRS	tø²+ɁenɁ¹³	tø²+ɁenɁ¹
rón²	V;IPFV;PL;1;PRS	ron³	ron³
Ɂo¹²	V;IPFV;PL;1;PRS	Ɂøg²	Ɂog²
hǿɁ²	V;IPFV;PL;1;PRS	høɁ¹²	høɁ¹
hnǿ²	V;IPFV;PL;1;PRS	hnø¹²	hnø¹
hnaiɁ¹²	V;IPFV;PL;1;PRS	hnaiɁ³	hnaiɁ²²
tai²	V;IPFV;PL;1;PRS	tei³	tai²
mi²+tan¹³	V;IPFV;PL;1;PRS	mi²+tan¹³	mi²+tan¹
ɁuǿɁ¹²	V;IPFV;PL;1;PRS	ɁuøɁ¹³	ɁuøɁ¹²
guønɁ¹²	V;IPFV;PL;1;PRS	guønɁ¹²	guønɁ¹²
kán²	V;IPFV;PL;1;PRS	kian¹²	kan²
háinɁ¹²	V;IPFV;PL;1;PRS	hainɁ²	hainɁ¹²
dsø²+huen¹³	V;IPFV;PL;1;PRS	dsø²+huen¹³	dsø²+huen
lag²	V;IPFV;PL;1;PRS	lag²	lag²
kiúgɁ²	V;IPFV;PL;1;PRS	kiugɁ³	kiugɁ³
bán²	V;IPFV;PL;1;PRS	ban¹²	ban¹
mi²+tég²	V;IPFV;PL;1;PRS	mi²+teg³	mi²+teg
kiuɁ¹²	V;IPFV;PL;1;PRS	kiuɁ²	kiuɁ¹³
guøn¹²	V;IPFV;PL;1;PRS	guøn¹²	guøn¹²
mi²+gug¹	V;IPFV;PL;1;PRS	mi²+gug¹	mi²+gug
len¹²	V;IPFV;PL;1;PRS	len¹²	len¹¹
rǿnɁ¹²	V;IPFV;PL;1;PRS	rønɁ³	rønɁ³²
gog²	V;IPFV;PL;1;PRS	gog²	gog¹
niá²	V;IPFV;PL;1;PRS	nia²	nia²
chióɁ¹²	V;IPFV;PL;1;PRS	chioɁ³	chioɁ³²
siúg²	V;IPFV;PL;1;PRS	siug³	siug³
huánɁ²	V;IPFV;PL;1;PRS	huanɁ¹²	huanɁ³
dsiag¹²	V;IPFV;PL;1;PRS	dsiag²	dsiag¹²
guiónɁ²	V;IPFV;PL;1;PRS	guionɁ³	guionɁ³
hanɁ¹² dsǿa¹²	V;IPFV;PL;1;PRS	hanɁ¹²	hanɁ¹²³³¹³²
ngié²	V;IPFV;PL;1;PRS	ngie²	ngie²
tsogɁ² hmøi²	V;IPFV;PL;1;PRS	tsogɁ²	tsogɁ²Ɂ¹³¹
ɁnáiɁ¹²	V;IPFV;PL;1;PRS	ɁnaiɁ²	ɁnaiɁ²²
hnio³	V;IPFV;PL;1;PRS	hnio³	hnio³
Ɂngio¹²	V;IPFV;PL;1;PRS	Ɂngio¹²	Ɂngio¹²
ténɁ¹²	V;IPFV;PL;1;PRS	tenɁ¹³	tenɁ¹²
tán¹²	V;IPFV;PL;1;PRS	tig¹²	tan¹²
tson²	V;IPFV;PL;1;PRS	tson²	tson²
hen¹²	V;IPFV;PL;1;PRS	hen¹²	hen¹²
huǿin¹²	V;IPFV;PL;1;PRS	huøin²	huøin²³
tsón¹²	V;IPFV;PL;1;PRS	tson¹²	tson¹²
kii²+túg²	V;IPFV;PL;1;PRS	kii²+tog³	kii²+tog
dsoɁ²	V;IPFV;PL;1;PRS	dsoɁ²	dsoɁ²
køn¹²	V;IPFV;PL;1;PRS	køn²	kin²g
Ɂiog²	V;IPFV;PL;1;PRS	Ɂiog²	Ɂiog²
tsog²	V;IPFV;PL;1;PRS	tsog²	tsog²
kugɁ¹²	V;IPFV;PL;1;PRS	kugɁ¹³	kugɁ¹³
hne¹²	V;IPFV;PL;1;PRS	hngiu²	hne¹²
ɁioɁ¹²	V;IPFV;PL;1;PRS	ɁioɁ¹²	ɁioɁ²²
tsǿng²	V;IPFV;PL;1;PRS	tsøng¹²	tsøng¹
ku²+hmáɁ²	V;IPFV;PL;1;PRS	ku²+hmaɁ¹²	ku²+hmaɁ
hmóɁ¹²	V;IPFV;PL;1;PRS	hmoɁ³	hmoɁ³²
hngie¹²	V;IPFV;PL;1;PRS	hngie³	hngie³¹
nēɁ¹²	V;IPFV;PL;1;PRS	nēɁ¹²	nēɁ¹²
húɁ²	V;IPFV;PL;1;PRS	huɁ²	huɁ¹
mi²+dsiog¹	V;IPFV;PL;1;PRS	mi²+dsiog¹	mi²+dsiog
Ɂnia¹²	V;IPFV;PL;1;PRS	Ɂnia¹³	Ɂnia¹²
héin¹²	V;IPFV;PL;1;PRS	hein³	hein¹²
dsúgɁ²	V;IPFV;PL;1;PRS	dsugɁ³	dsugɁ³
ngie¹²	V;IPFV;PL;1;PRS	ngie¹³	ngie³²
dsiánɁ¹²	V;IPFV;PL;1;PRS	dsianɁ¹²	dsianɁ¹
kieg²	V;IPFV;PL;1;PRS	kieg²	kieg²
køin²	V;IPFV;PL;1;PRS	kiing²	kiing
chiáng¹²	V;IPFV;PL;1;PRS	chiang²	chiang²
ɁēnɁ¹²	V;IPFV;PL;1;PRS	ɁenɁ²	ɁēnɁ¹²
kióɁ¹²	V;IPFV;PL;1;PRS	kioɁ³	kioɁ¹²
Ɂlúg²	V;IPFV;PL;1;PRS	Ɂlug²	Ɂlug²
gǿaɁ¹²	V;IPFV;PL;1;PRS	kie¹²	giaɁ²²
guen²	V;IPFV;PL;1;PRS	guøi²	guen²
hngēɁ¹²	V;IPFV;PL;1;PRS	hngēɁ²	hngēɁ²²
hmǿɁ¹²	V;IPFV;PL;1;PRS	hmøɁ²	hmøɁ¹²
tsénɁ²	V;IPFV;PL;1;PRS	tsenɁ¹²	tsenɁ¹
chiunɁ¹²	V;IPFV;PL;1;PRS	chiunɁ²	chiunɁ²
Ɂméi¹²	V;IPFV;PL;1;PRS	Ɂmei³	Ɂmei¹²
tióɁ¹²	V;IPFV;PL;1;PRS	tioɁ¹²	tioɁ¹²
tø²+húg³	V;IPFV;PL;1;PRS	tø²+hug³	tø²+hug
tsēn¹²	V;IPFV;PL;1;PRS	tsig²	tsēn¹²
mi²+Ɂlí¹	V;IPFV;PL;1;PRS	mi²+Ɂli³	mi²+Ɂli
dsen³ (kaɁ³)	V;IPFV;PL;1;PRS	dsen¹³	dsen¹³³³²²
chiogɁ¹²	V;IPFV;PL;1;PRS	chiogɁ¹²	chiogɁ¹
chi²+lánɁ²	V;IPFV;PL;1;PRS	chi²+lanɁ¹²	chi²+lanɁ
Ɂén²	V;IPFV;PL;1;PRS	Ɂen¹²	Ɂen¹
uǿi²	V;IPFV;PL;1;PRS	uøi¹²	uøi¹
tø²+gugɁ¹²	V;IPFV;PL;1;PRS	tø²+gugɁ¹²	tø²+gugɁ¹
mi²+hlíɁ²	V;IPFV;PL;1;PRS	mi²+hliɁ³	mi²+hliɁ
mi²+níɁ¹	V;IPFV;PL;1;PRS	mi²+niɁ³	mi²+niɁ
búɁ²	V;IPFV;PL;1;PRS	buɁ¹²	buɁ¹
køɁ³ (hmai³)	V;IPFV;PL;1;PRS	køɁ³	køɁ³Ɂ³²¹³¹
Ɂiei¹²	V;IPFV;PL;1;PRS	Ɂiei²	Ɂiei¹²
hngiángɁ¹²	V;IPFV;PL;1;PRS	hngiangɁ³	hngiangɁ³
tsø²+han¹²	V;IPFV;PL;1;PRS	tsø²+han¹²	tsø²+han¹
kién¹²	V;IPFV;PL;1;PRS	kien¹³	kien¹³
mi²+hngió¹	V;IPFV;PL;1;PRS	mi²+hngio¹³	mi²+hngio
chión²	V;IPFV;PL;1;PRS	chion³	chion³
guianɁ¹²	V;IPFV;PL;1;PRS	guianɁ²	guianɁ¹
hmḗɁ²	V;IPFV;PL;1;PRS	hmēɁ³	hmēɁ³
Ɂiog¹²	V;IPFV;PL;1;PRS	Ɂiog¹²	Ɂiog²²
dsø²+togɁ¹²	V;IPFV;PL;1;PRS	dsø²+togɁ¹²	dsø²+togɁ
dsiég¹²	V;IPFV;PL;1;PRS	dsieg¹²	dsieg¹²
mi²+dsíg²	V;IPFV;PL;1;PRS	mi²+dsig³	mi²+dsig
hnáɁ²	V;IPFV;PL;1;PRS	hnaɁ³	hnaɁ³
huúɁ²	V;IPFV;PL;1;PRS	huuɁ²	huuɁ³
mi²+gan¹²	V;IPFV;PL;1;PRS	mi²+gan¹³	mi²+gan¹
lieɁ¹²	V;IPFV;PL;1;PRS	lieɁ³	lieɁ¹²
ɁiéiɁ¹²	V;IPFV;PL;1;PRS	ɁieiɁ²	ɁieiɁ²²
ti²+dsǿ²	V;IPFV;PL;1;PRS	ti²+dsø³	ti²+dsø
káiɁ¹²	V;IPFV;PL;1;PRS	kieiɁ¹²	kaiɁ¹²
chi²+hné¹	V;IPFV;PL;1;PRS	chi²+hne³	chi²+hne
guen¹²	V;IPFV;PL;1;PRS	guen³	guen¹²
mi²+hǿ²	V;IPFV;PL;1;PRS	mi²+hø³	mi²+hø³
tónɁ² (huu¹²)	V;IPFV;PL;1;PRS	tiunɁ¹²	tiunɁ¹²³¹³(
hogɁ¹²	V;IPFV;PL;1;PRS	hogɁ¹²	hogɁ¹²
mi²+kánɁ²	V;IPFV;PL;1;PRS	mi²+kanɁ³	mi²+kanɁ
Ɂuan¹²	V;IPFV;PL;1;PRS	Ɂuan¹³	Ɂuan¹³
li²	V;IPFV;PL;1;PRS	li²	li²²
Ɂúg²	V;IPFV;PL;1;PRS	Ɂug¹²	Ɂug²
kēnɁ¹²	V;IPFV;PL;1;PRS	kienɁ¹²	kēnɁ¹¹
dsióɁ¹²	V;IPFV;PL;1;PRS	dsioɁ³	dsioɁ³³
tsiɁ¹²	V;IPFV;PL;1;PRS	tsiɁ²	tsiɁ²²
kiéɁ¹²	V;IPFV;PL;1;PRS	kieɁ³	kieɁ¹²
bén²	V;IPFV;PL;1;PRS	ben¹²	ben¹
hlái²	V;IPFV;PL;1;PRS	hlai¹²	hlai³
ngiú²	V;IPFV;PL;1;PRS	ngiu²	ngiu²
lúg²	V;IPFV;PL;1;PRS	lug²	lug²
tag¹²	V;IPFV;PL;1;PRS	teg²	tag¹²
mi²+Ɂai¹	V;IPFV;PL;1;PRS	mi²+Ɂai¹	mi²+Ɂai
kiog¹²	V;IPFV;PL;1;PRS	kiog²	kiog²²
chi²+dsén²	V;IPFV;PL;1;PRS	chi²+dsen¹³	chi²+dsen
hlán²	V;IPFV;PL;1;PRS	hlan³	hlan³
dsan²	V;IPFV;PL;1;PRS	dsan²	dsan²
ɁónɁ²	V;IPFV;PL;1;PRS	ɁonɁ³	ɁonɁ¹
hmáɁ² (ta³)	V;IPFV;PL;1;PRS	hmaɁ¹³	hmaɁ¹³Ɂ²¹
tiun¹²	V;IPFV;PL;1;PRS	teng¹²	tiun¹²
lø²+liúɁ²	V;IPFV;PL;1;PRS	lø²+liuɁ¹²	lø²+liuɁ
dsǿɁ²	V;IPFV;PL;1;PRS	dsøɁ¹²	dsøɁ¹
guian¹²	V;IPFV;PL;1;PRS	guian¹³	guian¹²
Ɂien²	V;IPFV;PL;1;PRS	Ɂien²	Ɂien²
guiúnɁ¹²	V;IPFV;PL;1;PRS	guiunɁ¹²	guiunɁ¹
mi²+kuen¹²	V;IPFV;PL;1;PRS	mi²+kuen¹³	mi²+kuen¹
hliánɁ²	V;IPFV;PL;1;PRS	hlianɁ¹³	hlianɁ¹
mi²+gǿg¹	V;IPFV;PL;1;PRS	mi²+gøg¹	mi²+gøg
Ɂmǿi²	V;IPFV;PL;1;PRS	Ɂmai¹²	Ɂmøi¹
chi²+ngió²	V;IPFV;PL;1;PRS	chi²+ngio³	chi²+ngio
hnó²	V;IPFV;PL;1;PRS	hno³	hno³
ti²+dsiog¹	V;IPFV;PL;1;PRS	ti²+dsiog³	ti²+dsiog
Ɂnē¹²	V;IPFV;PL;1;PRS	Ɂnē¹²	Ɂnē¹²
Ɂngieng¹²	V;IPFV;PL;1;PRS	Ɂngieng²	Ɂngieng³
hlég²	V;IPFV;PL;1;PRS	hleg²	hleg²
dsii²+lian¹	V;IPFV;PL;1;PRS	dsii²+lian¹	dsii²+lia
hné¹²	V;IPFV;PL;1;PRS	hne³	hne¹²
gǿi¹²	V;IPFV;PL;1;PRS	guiig²	gøi¹²
tsón²	V;IPFV;PL;1;PRS	tson³	tson³
chiog¹²	V;IPFV;PL;1;PRS	chiog¹²	chiog¹²
húgɁ²	V;IPFV;PL;1;PRS	hogɁ¹²	hugɁ³
mái¹²	V;IPFV;PL;1;PRS	mai²	mai²¹
kiáɁ²	V;IPFV;PL;1;PRS	kiaɁ¹³	kiaɁ³
mi²+rø¹²	V;IPFV;PL;1;PRS	mi²+rø³	mi²+rø³
tiú²	V;IPFV;PL;1;PRS	tiu¹²	tiu¹
hiugɁ¹²	V;IPFV;PL;1;PRS	hiugɁ³	hiugɁ²²
kií¹²	V;IPFV;PL;1;PRS	kii²	kii¹²
kian¹²	V;IPFV;PL;1;PRS	kian³	kian¹³
mi²+hínɁ²	V;IPFV;PL;1;PRS	mi²+hinɁ³	mi²+hinɁ
ɁnáɁ¹²	V;IPFV;PL;1;PRS	ɁniaɁ¹²	ɁnaɁ¹¹
tso¹²	V;IPFV;PL;1;PRS	chieg²	tso¹²
siég²	V;IPFV;PL;1;PRS	sieg¹²	sieg³
sianɁ¹²	V;IPFV;PL;1;PRS	sianɁ¹³	sianɁ¹³
nió²	V;IPFV;PL;1;PRS	nio¹²	nio¹
kien¹²	V;IPFV;PL;1;PRS	kien¹³	kien¹³
tsén²	V;IPFV;PL;1;PRS	tsen³	tsen³
búɁ¹²	V;IPFV;PL;1;PRS	buɁ¹²	buɁ¹²
Ɂuan²	V;IPFV;PL;1;PRS	Ɂuan²	Ɂuan¹
mi²+hniang¹ ni³	V;IPFV;PL;1;PRS	mi²+hniang³	mi²+hniang³(
mi²+guionɁ¹	V;IPFV;PL;1;PRS	mi²+guionɁ³	mi²+guion
tagɁ²	V;IPFV;PL;1;PRS	tiagɁ²	tagɁ¹
kúgɁ²	V;IPFV;PL;1;PRS	kogɁ³	kugɁ³
Ɂma¹²	V;IPFV;PL;1;PRS	Ɂma¹²	Ɂma¹²
chiágɁ¹²	V;IPFV;PL;1;PRS	chiagɁ²	chiagɁ²
tø²+kanɁ¹³	V;IPFV;PL;1;PRS	tø²+kanɁ¹³	tø²+kanɁ¹
hiégɁ¹²	V;IPFV;PL;1;PRS	hiegɁ²	hiegɁ²²
ngáɁ¹²	V;IPFV;PL;1;PRS	ngaɁ²	ngaɁ³¹
mi²+dsií¹	V;IPFV;PL;1;PRS	mi²+dsii³	mi²+dsii
tóɁ¹²	V;IPFV;PL;1;PRS	tioɁ¹²	toɁ¹²
tanɁ¹² huu¹²	V;IPFV;PL;1;PRS	tianɁ²	tianɁ²¹³³¹
kán² guiing²	V;IPFV;PL;1;PRS	kan¹²	kan¹²¹²²³¹
Ɂug¹²	V;IPFV;PL;1;PRS	Ɂug¹³	Ɂug¹²
hái¹²	V;IPFV;PL;1;PRS	hai²	hai²²
ián²	V;IPFV;PL;1;PRS	ian¹²	ian¹
hén²	V;IPFV;PL;1;PRS	hen²	hen¹
mi²+Ɂan¹²	V;IPFV;PL;1;PRS	mi²+Ɂan¹³	mi²+Ɂan¹
dsēn¹²	V;IPFV;PL;1;PRS	dsēn¹³	dsēn¹²
hiúgɁ²	V;IPFV;PL;1;PRS	hiugɁ³	hiugɁ³
hngieng¹²	V;IPFV;PL;1;PRS	hngieng³	hngieng³
tsai¹²	V;IPFV;PL;1;PRS	tsai¹²	tsai¹²
pø²+hánɁ²	V;IPFV;PL;1;PRS	pø²+hanɁ¹²	pø²+hanɁ
lá¹²	V;IPFV;PL;1;PRS	lie¹²	lag²
bí²	V;IPFV;PL;1;PRS	bi¹²	bi¹²
Ɂø²+tsúgɁ²	V;IPFV;PL;1;PRS	Ɂø²+tsogɁ²	Ɂø²+tsogɁ
ɁaiɁ²	V;IPFV;PL;1;PRS	ɁeiɁ²	ɁaiɁ²
mi²+kiín¹	V;IPFV;PL;1;PRS	mi²+kiin³	mi²+kiin
ié²	V;IPFV;PL;1;PRS	ie¹²	ie¹²
hønɁ¹²	V;IPFV;PL;1;PRS	hinɁ¹²	hinɁ¹²
tsøi¹²	V;IPFV;PL;1;PRS	tsøi²	tsøi²²
gúg²	V;IPFV;PL;1;PRS	gug¹²	gug¹
kuǿɁ¹²	V;IPFV;PL;1;PRS	kuøɁ¹²	kuøɁ¹²
Ɂuǿi²	V;IPFV;PL;1;PRS	Ɂuai¹²	Ɂuøi¹
tiánɁ¹²	V;IPFV;PL;1;PRS	tianɁ¹²	tianɁ¹²
hnióɁ²	V;IPFV;PL;1;PRS	hnioɁ²	hnioɁ³
tsenɁ¹²	V;IPFV;PL;1;PRS	tsenɁ¹²	tsenɁ¹²
guieng¹²	V;IPFV;PL;1;PRS	guieng²	guieng²
ɁǿnɁ²	V;IPFV;PL;1;PRS	ɁniuɁ²	ɁønɁ²
Ɂe¹²	V;IPFV;PL;1;PRS	Ɂe²	Ɂe²²
kuénɁ²	V;IPFV;PL;1;PRS	kuenɁ³	kuenɁ³
chiángɁ¹²	V;IPFV;PL;1;PRS	chiangɁ³	chiangɁ³
mē¹²	V;IPFV;PL;1;PRS	mē¹²	mē¹²
mi²+kiónɁ²	V;IPFV;PL;1;PRS	mi²+kionɁ³	mi²+kionɁ
kiagɁ¹²	V;IPFV;PL;1;PRS	kiagɁ²	kiagɁ¹³
ɁmóɁ²	V;IPFV;PL;1;PRS	ɁmoɁ¹²	ɁmoɁ³
sián²	V;IPFV;PL;1;PRS	sian³	sian³
tian¹	V;IPFV;PL;1;PRS	tian¹	tian¹
guiugɁ²	V;IPFV;PL;1;PRS	guiugɁ²	guiugɁ²
ɁmēɁ¹²	V;IPFV;PL;1;PRS	ɁmēɁ¹²	ɁmēɁ¹²
mi²+hní¹	V;IPFV;PL;1;PRS	mi²+hni³	mi²+hni
nié¹²	V;IPFV;PL;1;PRS	nie²	nie¹²
ɁenɁ¹²	V;IPFV;PL;1;PRS	ɁenɁ¹³	ɁenɁ¹²
ɁøɁ¹²	V;IPFV;PL;1;PRS	ɁiɁ¹²	ɁiɁ¹²
kang²	V;IPFV;PL;1;PRS	kieng²	kang²
liúg²	V;IPFV;PL;1;PRS	log³	liug²
ngǿi²	V;IPFV;PL;1;PRS	ngai¹²	ngøi²
togɁ¹²	V;IPFV;PL;1;PRS	tiogɁ²	togɁ¹²
hḗɁ²	V;IPFV;PL;1;PRS	hēɁ²	hēɁ²
kø²+hinɁ¹²	V;IPFV;PL;1;PRS	kø²+hinɁ³	kø²+hinɁ³
guenɁ¹²	V;IPFV;PL;1;PRS	guenɁ¹²	guenɁ¹²
hénɁ¹²	V;IPFV;PL;1;PRS	henɁ¹³	henɁ¹³
siúgɁ²	V;IPFV;PL;1;PRS	siugɁ²	siugɁ²
hnáɁ¹²	V;IPFV;PL;1;PRS	hnaɁ¹²	hnaɁ¹¹
lánɁ²	V;IPFV;PL;1;PRS	lanɁ¹²	lanɁ¹
Ɂnie¹²	V;IPFV;PL;1;PRS	Ɂnie³	Ɂnie¹²
ngieɁ¹³	V;IPFV;PL;1;PRS	ngieɁ¹³	ngieɁ¹³
lióg¹²	V;IPFV;PL;1;PRS	liog¹²	liog¹²
mi²+gan¹	V;IPFV;PL;1;PRS	mi²+gan¹	mi²+gan
kón²	V;IPFV;PL;1;PRS	kon³	kon³
ɁliágɁ¹²	V;IPFV;PL;1;PRS	ɁliagɁ²	ɁliagɁ¹
Ɂnai¹²	V;IPFV;PL;1;PRS	Ɂnøi²	Ɂnai²²
hngió²	V;IPFV;PL;1;PRS	hngio¹²	hngio¹
chióg¹²	V;IPFV;PL;1;PRS	chiog³	chiog³²
Ɂme¹²	V;IPFV;PL;1;PRS	Ɂme²	Ɂme²²
Ɂé²	V;IPFV;PL;1;PRS	Ɂe²	Ɂe²²
Ɂmóng¹²	V;IPFV;PL;1;PRS	Ɂmong¹²	Ɂmong¹²
Ɂog¹²	V;IPFV;PL;1;PRS	Ɂog¹²	Ɂog¹²
kø¹²	V;IPFV;PL;1;PRS	kø²	ki²²
u¹+lian¹	V;IPFV;PL;1;PRS	u²+lian¹	u²+lian
Ɂian¹²	V;IPFV;PL;1;PRS	Ɂian¹²	Ɂian¹²
bø²+lḗnɁ²	V;IPFV;PL;1;PRS	bø²+lēnɁ²	bø²+lēnɁ
mi²+dsian¹²	V;IPFV;PL;1;PRS	mi²+dsian¹³	mi²+dsian
kēn²	V;IPFV;PL;1;PRS	kēn³	kēn³
kiang¹²	V;IPFV;PL;1;PRS	kiang¹³	kiang¹²
ɁánɁ²	V;IPFV;PL;1;PRS	ɁanɁ¹²	ɁanɁ¹
guu²+dsḗn¹³	V;IPFV;PL;1;PRS	guu²+dsēn¹³	guu²+dsēn
guiánɁ¹²	V;IPFV;PL;1;PRS	guianɁ¹²	guianɁ¹
hniá¹²	V;IPFV;PL;1;PRS	hnia¹²	hnia¹²
hlíɁ¹²	V;IPFV;PL;1;PRS	hliɁ²	hliɁ²²
ɁlieɁ¹²	V;IPFV;PL;1;PRS	ɁlieɁ²	ɁlieɁ²²
huen¹²	V;IPFV;PL;1;PRS	huen¹³	huen¹³
ieg¹²	V;IPFV;PL;1;PRS	ieg²	ieg²²
rain¹²	V;IPFV;PL;1;PRS	rain¹²	rain¹²
hog¹²	V;IPFV;PL;1;PRS	hog¹²	hog¹²
lan²	V;IPFV;PL;1;PRS	lan²	lan²
ɁénɁ¹²	V;IPFV;PL;1;PRS	ɁenɁ¹²	ɁenɁ¹²
tsá¹²	V;IPFV;PL;1;PRS	tsa²	tsa¹³
siog²	V;IPFV;PL;1;PRS	siog²	siog²
guiég¹²	V;IPFV;PL;1;PRS	guieg²	guieg¹²
huu¹²	V;IPFV;PL;1;PRS	huu³	huu²²
tsíɁ¹²	V;IPFV;PL;1;PRS	tsiɁ¹²	tsiɁ¹²
Ɂéng²	V;IPFV;PL;1;PRS	Ɂeng¹²	Ɂeng²
tan¹³	V;IPFV;PL;1;PRS	tan¹³	tan¹³
ɁiíɁ²	V;IPFV;PL;1;PRS	ɁiiɁ¹²	ɁiiɁ²
ku²+guénɁ²	V;IPFV;PL;1;PRS	ku²+guenɁ³	ku²+guenɁ
hnéi¹²	V;IPFV;PL;1;PRS	hnei²	hnei¹²
koɁ¹²	V;IPFV;PL;1;PRS	koɁ¹²	koɁ¹²
kánɁ¹²	V;IPFV;PL;1;PRS	kanɁ¹³	kanɁ¹²
Ɂai¹²	V;IPFV;PL;1;PRS	Ɂei²	Ɂai²²
mi²+dsiagɁ¹	V;IPFV;PL;1;PRS	mi²+dsiagɁ³	mi²+dsiag
téng²	V;IPFV;PL;1;PRS	teng²	teng²
mi²+ti¹	V;IPFV;PL;1;PRS	mi²+ti³	mi²+ti³
chionɁ¹²	V;IPFV;PL;1;PRS	chionɁ¹³	chionɁ¹
tógɁ¹²	V;IPFV;PL;1;PRS	tiagɁ²	togɁ¹²
mi²+liág¹	V;IPFV;PL;1;PRS	mi²+liag¹³	mi²+liag
dsanɁ¹²	V;IPFV;PL;1;PRS	dsanɁ¹²	dsanɁ¹²
téiɁ²	V;IPFV;PL;1;PRS	teiɁ¹²	teiɁ²
neɁ¹²	V;IPFV;PL;1;PRS	neɁ³	neɁ¹²
høn¹²	V;IPFV;PL;1;PRS	hin²	hin¹²
hógɁ¹²	V;IPFV;PL;1;PRS	hogɁ¹²	hogɁ¹²
mi²+dsē¹²	V;IPFV;PL;1;PRS	mi²+dsē¹³	mi²+dsē¹
kuø¹²	V;IPFV;PL;1;PRS	kuø²	kuø²²
kián²	V;IPFV;PL;1;PRS	kian¹²	kian³
hiúɁ²	V;IPFV;PL;1;PRS	hioɁ³	hiuɁ³
ɁiuɁ³ (ɁéɁ¹)	V;IPFV;PL;1;PRS	ɁiuɁ³	ɁiuɁ³¹²²³¹
ɁiúɁ¹²	V;IPFV;PL;1;PRS	ɁiuɁ³	ɁiuɁ¹²
kiiɁ²	V;IPFV;PL;1;PRS	kiiɁ²	kiiɁ²
hlǿ²	V;IPFV;PL;1;PRS	hlø¹²	hlø¹
tan¹²	V;IPFV;PL;1;PRS	tan¹²	tan¹²
ko¹²	V;IPFV;PL;1;PRS	køg²	kog²
ti²+dsøa¹²	V;IPFV;PL;1;PRS	ti²+dsøa³	ti²+dsøa³
tiu¹²	V;IPFV;PL;1;PRS	tiu²	tiu¹²
chi²+láɁ²	V;IPFV;PL;1;PRS	chi²+laɁ¹²	chi²+laɁ
Ɂen¹³	V;IPFV;PL;1;PRS	Ɂen¹³	Ɂen¹³
siúɁ²	V;IPFV;PL;1;PRS	siuɁ¹²	siuɁ³
ɁnangɁ²	V;IPFV;PL;1;PRS	ɁniangɁ²	ɁnangɁ²
húg²	V;IPFV;PL;1;PRS	hug²	hug²
ɁlogɁ²	V;IPFV;PL;1;PRS	ɁlogɁ²	ɁlogɁ²
siág¹²	V;IPFV;PL;1;PRS	siog³	siag¹²
mi²+hog¹²	V;IPFV;PL;1;PRS	mi²+hog³	mi²+hog³
kienɁ¹²	V;IPFV;PL;1;PRS	kienɁ¹³	kienɁ¹²
ɁløaɁ¹²	V;IPFV;PL;1;PRS	ɁløaɁ³	ɁløaɁ³²
Ɂiá¹²	V;IPFV;PL;1;PRS	Ɂia¹³	Ɂia¹³
chiínɁ²	V;IPFV;PL;1;PRS	chienɁ¹²	chienɁ¹
dsúgɁ¹²	V;IPFV;PL;1;PRS	dsugɁ¹²	dsugɁ¹²
héi²	V;IPFV;PL;1;PRS	hi¹²	hei²
mi²+dsiúg²	V;IPFV;PL;1;PRS	mi²+dsiug³	mi²+dsiug
hnia¹²	V;IPFV;PL;1;PRS	hnia¹²	hnia¹²
hnḗ¹²	V;IPFV;PL;1;PRS	hnē¹²	hnē¹³
u²+nio¹³	V;IPFV;PL;1;PRS	u²+nio¹³	u²+nio¹
mi²+Ɂog¹³	V;IPFV;PL;1;PRS	mi²+Ɂog³	mi²+Ɂog³
dsiánɁ²	V;IPFV;PL;1;PRS	dsianɁ³	dsianɁ¹
lēɁ²	V;IPFV;PL;1;PRS	lēɁ³	lēɁ³
mi²+Ɂan¹³	V;IPFV;PL;1;PRS	mi²+Ɂan¹³	mi²+Ɂan¹
kuú²	V;IPFV;PL;1;PRS	kuu²	kuu²
iéiɁ¹²	V;IPFV;PL;1;PRS	ieiɁ²	ieiɁ²²
bá²	V;IPFV;PL;1;PRS	ba¹²	ba¹²
kon¹²	V;IPFV;PL;1;PRS	kon¹²	kon¹²
bḗn²	V;IPFV;PL;1;PRS	bēn¹²	bēn¹
mi²+hlēnɁ¹	V;IPFV;PL;1;PRS	mi²+hlēnɁ³	mi²+hlēnɁ
nei¹²	V;IPFV;PL;1;PRS	nei³	nei³²
mi²+hniang¹ dsǿa¹²	V;IPFV;PL;1;PRS	mi²+hniang³	mi²+hniang³((((
huánɁ¹²	V;IPFV;PL;1;PRS	huanɁ¹²	huanɁ¹²
rang¹²	V;IPFV;PL;1;PRS	rang²	rang²²
hínɁ¹²	V;IPFV;PL;1;PRS	hinɁ³	hinɁ³²
ɁmíɁ²	V;IPFV;PL;1;PRS	ɁmiɁ²	ɁmiɁ²
Ɂēn¹²	V;IPFV;PL;1;PRS	Ɂēn¹²	Ɂēn¹²
kánɁ²	V;IPFV;PL;1;PRS	kanɁ¹²	kanɁ¹
ɁéɁ¹²	V;IPFV;PL;1;PRS	ɁeɁ¹²	ɁeɁ¹²
mi²+ténɁ²	V;IPFV;PL;1;PRS	mi²+tenɁ³	mi²+tenɁ
háng¹²	V;IPFV;PL;1;PRS	hang³	hang¹²
nung²	V;IPFV;PL;1;PRS	nung²	nung²
kḗn²	V;IPFV;PL;1;PRS	kēn²	kēn²
ton²	V;IPFV;PL;1;PRS	ton²	ton²
u²+Ɂai¹²	V;IPFV;PL;1;PRS	u²+Ɂai¹²	u²+Ɂai¹
chi²+ngiú²	V;IPFV;PL;1;PRS	chi²+ngiu³	chi²+ngiu
hug²	V;IPFV;PL;1;PRS	hug²	hug²
lø²+liugɁ³	V;IPFV;PL;1;PRS	lø²+liugɁ³	lø²+liugɁ
dsen¹²	V;IPFV;PL;1;PRS	dsen¹²	dsen¹¹
kiúɁ¹²	V;IPFV;PL;1;PRS	kiuɁ²	kiuɁ³³
tsáiɁ¹²	V;IPFV;SG;1;PRS	huøi²	tsaiɁ¹²
kø²+káng¹²	V;IPFV;SG;1;PRS	kø²+kang¹²	kø²+kang
guiágɁ¹²	V;IPFV;SG;1;PRS	guiagɁ¹²	guiagɁ¹
ɁnóɁ¹² dsí²	V;IPFV;SG;1;PRS	ɁnoɁ¹²	ɁnoɁ¹²²³¹
dsánɁ¹²	V;IPFV;SG;1;PRS	dsanɁ¹²	dsanɁ¹²
lǿɁ²	V;IPFV;SG;1;PRS	løi²	løɁ¹²
tií²	V;IPFV;SG;1;PRS	tii¹²	tii¹²
guiénɁ²	V;IPFV;SG;1;PRS	guienɁ¹²	guienɁ¹
héinɁ¹²	V;IPFV;SG;1;PRS	heinɁ³	heinɁ¹²
mi²+kionɁ¹	V;IPFV;SG;1;PRS	mi²+kionɁ¹³	mi²+kion
hénɁ²	V;IPFV;SG;1;PRS	henɁ³	henɁ¹
hǿɁ¹²	V;IPFV;SG;1;PRS	tsøɁ¹²	høɁ¹²
chi²+dsán²	V;IPFV;SG;1;PRS	chi²+dsan²	chi²+dsa
guieɁ¹²	V;IPFV;SG;1;PRS	guieɁ¹²	guieɁ¹²
guiúg²	V;IPFV;SG;1;PRS	guiug³	guiug¹
Ɂon¹²	V;IPFV;SG;1;PRS	Ɂon¹²	Ɂon¹²
Ɂan¹²	V;IPFV;SG;1;PRS	Ɂan¹³	Ɂan¹²
dsian¹²	V;IPFV;SG;1;PRS	dsian¹²	dsian¹²
dság¹²	V;IPFV;SG;1;PRS	dsag¹²	dsag¹²
tsanɁ¹²	V;IPFV;SG;1;PRS	huanɁ³	tsanɁ¹²
tánɁ¹²	V;IPFV;SG;1;PRS	tanɁ¹²	tanɁ¹²
kuøin¹²	V;IPFV;SG;1;PRS	kuøin²	kuøin²²
ɁuáiɁ¹²	V;IPFV;SG;1;PRS	ɁuaiɁ¹²	ɁuaiɁ¹²
mi²+hénɁ²	V;IPFV;SG;1;PRS	mi²+henɁ³	mi²+henɁ
mi²+kiíngɁ²	V;IPFV;SG;1;PRS	mi²+kiingɁ³	mi²+kiing
tieɁ¹²	V;IPFV;SG;1;PRS	taɁ¹²	tieɁ¹²
hinɁ³	V;IPFV;SG;1;PRS	hinɁ³	hinɁ³
tian¹²	V;IPFV;SG;1;PRS	tian¹³	tian¹³
mi²+hmḗ²	V;IPFV;SG;1;PRS	mi²+hmē³	mi²+hmē
ngē¹²	V;IPFV;SG;1;PRS	ngē¹²	ngē¹²
lanɁ¹²	V;IPFV;SG;1;PRS	lanɁ¹²	lanɁ¹²
ngái¹²	V;IPFV;SG;1;PRS	ngai³	ngai¹²
tión²	V;IPFV;SG;1;PRS	ton²	tion¹
tsø²+kuenɁ¹²	V;IPFV;SG;1;PRS	tsø²+kuenɁ¹²	tsø²+kuen
Ɂøa¹²	V;IPFV;SG;1;PRS	Ɂøa¹²	Ɂøa¹²
hngiáɁ²	V;IPFV;SG;1;PRS	hngiaɁ²	hngiaɁ²
ngioɁ¹²	V;IPFV;SG;1;PRS	ngioɁ²	ngioɁ²³
ngøa¹²	V;IPFV;SG;1;PRS	ngøa¹²	ngøa¹²
ɁlianɁ²	V;IPFV;SG;1;PRS	ɁlianɁ²	ɁlianɁ³
hngióɁ¹²	V;IPFV;SG;1;PRS	hngioɁ¹³	hngioɁ¹
se¹²	V;IPFV;SG;1;PRS	se²	se¹²³
tsǿɁ¹²	V;IPFV;SG;1;PRS	tsøɁ¹²	tsøɁ¹²
ta¹²	V;IPFV;SG;1;PRS	ta¹²	ta¹²¹
rónɁ¹²	V;IPFV;SG;1;PRS	rang¹²	ronɁ¹²
ha²+Ɂan³	V;IPFV;SG;1;PRS	ha²+Ɂan³	ha²+Ɂan
kúgɁ¹²	V;IPFV;SG;1;PRS	kugɁ¹²	kugɁ¹²
huúɁ¹²	V;IPFV;SG;1;PRS	huuɁ³	huuɁ¹²
kágɁ¹²	V;IPFV;SG;1;PRS	kagɁ³	kagɁ¹²
guái²	V;IPFV;SG;1;PRS	guai¹²	guai¹
hḗnɁ²	V;IPFV;SG;1;PRS	hēnɁ¹³	hēnɁ¹
chi²+kián²	V;IPFV;SG;1;PRS	chi²+kian³	chi²+kia
hian¹²	V;IPFV;SG;1;PRS	han²	hian¹³
ku² hmo¹²	V;IPFV;SG;1;PRS	ku¹²	ku¹²¹²s³
kión²	V;IPFV;SG;1;PRS	kion³	kion³
téiɁ¹²	V;IPFV;SG;1;PRS	teiɁ¹²	teiɁ¹²
tsog¹²	V;IPFV;SG;1;PRS	tsog¹³	tsog¹²
ɁóɁ²	V;IPFV;SG;1;PRS	ɁoɁ¹²	ɁoɁ¹²
ngē²	V;IPFV;SG;1;PRS	ngē³	ngē³²
mi²+dsēn¹²	V;IPFV;SG;1;PRS	mi²+dsēn¹³	mi²+dsēn
rón²	V;IPFV;SG;1;PRS	ron²	ron²²
Ɂo¹²	V;IPFV;SG;1;PRS	Ɂo¹²	Ɂo¹²²
hnǿ²	V;IPFV;SG;1;PRS	hnø¹²	hnø¹²
mi²+tan¹³	V;IPFV;SG;1;PRS	mi²+tan¹³	mi²+tan¹
ɁuǿɁ¹²	V;IPFV;SG;1;PRS	ɁuøɁ¹³	ɁuøɁ¹²
guønɁ¹²	V;IPFV;SG;1;PRS	guønɁ¹²	guønɁ²²
kán²	V;IPFV;SG;1;PRS	kan¹²	kan¹²
háinɁ¹²	V;IPFV;SG;1;PRS	hainɁ¹²	hainɁ¹²
lag²	V;IPFV;SG;1;PRS	lag¹²	lag²²
kiúgɁ²	V;IPFV;SG;1;PRS	kiugɁ³	kiugɁ²
bán²	V;IPFV;SG;1;PRS	ban¹²	ban¹²
mi²+tég²	V;IPFV;SG;1;PRS	mi²+teg³	mi²+teg
kiuɁ¹²	V;IPFV;SG;1;PRS	kiuɁ¹²	kiuɁ¹²
guøn¹²	V;IPFV;SG;1;PRS	guøn¹²	guøn¹²
len¹²	V;IPFV;SG;1;PRS	len¹²	len¹²
rǿnɁ¹²	V;IPFV;SG;1;PRS	rønɁ³	rønɁ¹²
gog²	V;IPFV;SG;1;PRS	gog²	gog¹²
lán¹²	V;IPFV;SG;1;PRS	lan¹²	lan¹²
niá²	V;IPFV;SG;1;PRS	na¹²	nia³¹
Ɂno¹²	V;IPFV;SG;1;PRS	Ɂno¹²	Ɂno¹²
chióɁ¹²	V;IPFV;SG;1;PRS	chioɁ³	chioɁ³²
ngiéɁ¹²	V;IPFV;SG;1;PRS	ngieɁ³	ngieɁ¹²
siúg²	V;IPFV;SG;1;PRS	siug³	siug³
huánɁ²	V;IPFV;SG;1;PRS	huanɁ¹²	huanɁ¹
dsiag¹²	V;IPFV;SG;1;PRS	dsiag¹²	dsiag¹²
teng¹²	V;IPFV;SG;1;PRS	tøng¹²	teng¹²
guiónɁ²	V;IPFV;SG;1;PRS	guionɁ³	guionɁ³
hanɁ¹² dsǿa¹²	V;IPFV;SG;1;PRS	hanɁ¹²	hanɁ¹²u²¹³
méɁ²	V;IPFV;SG;1;PRS	meɁ¹²	meɁ¹²
ngié²	V;IPFV;SG;1;PRS	ngie²	ngie¹
ɁnáiɁ¹²	V;IPFV;SG;1;PRS	ɁnaiɁ¹²	ɁnaiɁ¹²
Ɂngio¹²	V;IPFV;SG;1;PRS	Ɂngio¹²	Ɂngio¹²
guǿn¹²	V;IPFV;SG;1;PRS	guøn¹²	guøn¹²
tán¹²	V;IPFV;SG;1;PRS	tan¹²	tan¹²
tson²	V;IPFV;SG;1;PRS	tson²	tson²
Ɂio¹²	V;IPFV;SG;1;PRS	Ɂio¹²	Ɂio¹²
hen¹²	V;IPFV;SG;1;PRS	hen³	hen¹²
hián²	V;IPFV;SG;1;PRS	hian¹²	hian¹
huǿin¹²	V;IPFV;SG;1;PRS	huøin¹²	huøin¹²
tsón¹²	V;IPFV;SG;1;PRS	tson¹²	tson¹²
kii²+túg²	V;IPFV;SG;1;PRS	kii²+tog³	kii²+tog
kii²+tág¹²	V;IPFV;SG;1;PRS	kii²+tag¹²	kii²+tag
hngia¹²	V;IPFV;SG;1;PRS	han¹³	han¹³¹²
Ɂán²	V;IPFV;SG;1;PRS	Ɂan²	Ɂan¹²
tsog²	V;IPFV;SG;1;PRS	tsog²	tsog²
kugɁ¹²	V;IPFV;SG;1;PRS	kugɁ¹³	kugɁ¹³
ku²+hmáɁ²	V;IPFV;SG;1;PRS	ku²+hmaɁ¹²	ku²+hmaɁ
hngie¹²	V;IPFV;SG;1;PRS	han³	han³²¹²
húɁ²	V;IPFV;SG;1;PRS	huɁ²	huɁ²²
mi²+dsiog¹	V;IPFV;SG;1;PRS	mi²+dsiog¹	mi²+dsio
Ɂnia¹²	V;IPFV;SG;1;PRS	Ɂnia¹³	Ɂnia¹³
héin¹²	V;IPFV;SG;1;PRS	hein³	hein¹³
ngie¹²	V;IPFV;SG;1;PRS	ngie¹³	ngie¹²
kieg²	V;IPFV;SG;1;PRS	ko¹²	kieg¹
mi²+tan¹²	V;IPFV;SG;1;PRS	mi²+tan³	mi²+tan³
køin²	V;IPFV;SG;1;PRS	køin¹²	køin¹
chiáng¹²	V;IPFV;SG;1;PRS	chiang¹²	chiang¹
ɁēnɁ¹²	V;IPFV;SG;1;PRS	ɁēnɁ²	ɁēnɁ²²
kióɁ¹²	V;IPFV;SG;1;PRS	kioɁ³	kioɁ¹²
Ɂlúg²	V;IPFV;SG;1;PRS	Ɂlug²	Ɂlug²
møa¹²	V;IPFV;SG;1;PRS	møa¹²	møa¹²
gǿaɁ¹²	V;IPFV;SG;1;PRS	gøaɁ¹²	gøaɁ¹²
guen²	V;IPFV;SG;1;PRS	guen²	guen²
tug	V;IPFV;SG;1;PRS	tug¹²	tug¹
hngēɁ¹²	V;IPFV;SG;1;PRS	hngēɁ²	hngēɁ²²
hmǿɁ¹²	V;IPFV;SG;1;PRS	hmøɁ¹²	hmøɁ¹²
dsie¹²	V;IPFV;SG;1;PRS	dsie¹²	dsie¹²
tsénɁ²	V;IPFV;SG;1;PRS	tsēnɁ²	tsenɁ²
chiunɁ¹²	V;IPFV;SG;1;PRS	chiunɁ¹²	chiunɁ¹
Ɂméi¹²	V;IPFV;SG;1;PRS	Ɂmei³	Ɂmei³²
tióɁ¹²	V;IPFV;SG;1;PRS	tiag¹²	tioɁ¹²
tø²+húg³	V;IPFV;SG;1;PRS	tø²+hug³	tø²+hug
tsēn¹²	V;IPFV;SG;1;PRS	tsēn¹²	tsēn¹³
mi²+Ɂlí¹	V;IPFV;SG;1;PRS	mi²+Ɂli³	mi²+Ɂli
chiogɁ¹²	V;IPFV;SG;1;PRS	chiogɁ¹²	chiogɁ¹
Ɂén²	V;IPFV;SG;1;PRS	Ɂen¹²	Ɂen¹²
hánɁ²	V;IPFV;SG;1;PRS	hanɁ¹²	hanɁ¹
tsø²+kuønɁ¹²	V;IPFV;SG;1;PRS	tsø²+kuønɁ¹²	tsø²+kuøn
uǿi²	V;IPFV;SG;1;PRS	uøi²	uøi²³
mi²+kuuɁ¹²	V;IPFV;SG;1;PRS	mi²+kuuɁ¹³	mi²+kuuɁ
tø²+gugɁ¹²	V;IPFV;SG;1;PRS	tø²+gugɁ¹²	tø²+gugɁ
mi²+hlíɁ²	V;IPFV;SG;1;PRS	mi²+hliɁ³	mi²+hliɁ
mi²+níɁ¹	V;IPFV;SG;1;PRS	mi²+niɁ³	mi²+niɁ
búɁ²	V;IPFV;SG;1;PRS	buɁ¹²	buɁ¹²
køɁ³ (hmai³)	V;IPFV;SG;1;PRS	kai³	kai³²¹²²¹
Ɂiei¹²	V;IPFV;SG;1;PRS	Ɂiei¹²	Ɂiei²²
niuɁ³	V;IPFV;SG;1;PRS	niuɁ³	niuɁ³
hngiángɁ¹²	V;IPFV;SG;1;PRS	hngiangɁ³	hngiangɁ
tsø²+han¹²	V;IPFV;SG;1;PRS	tsø²+han¹²	tsø²+han
kién¹²	V;IPFV;SG;1;PRS	kien¹³	kien¹³
hḗn²	V;IPFV;SG;1;PRS	hēn¹²	hēn²²
ngai¹²	V;IPFV;SG;1;PRS	ngai³	ngai¹²
chión²	V;IPFV;SG;1;PRS	chion³	chion³
guianɁ¹²	V;IPFV;SG;1;PRS	guianɁ²	guianɁ¹
hmḗɁ²	V;IPFV;SG;1;PRS	hmēɁ³	hmēɁ³
Ɂiog¹²	V;IPFV;SG;1;PRS	Ɂog¹²	Ɂiog²³
dsø²+togɁ¹²	V;IPFV;SG;1;PRS	dsø²+togɁ¹²	dsø²+togɁ
dsiég¹²	V;IPFV;SG;1;PRS	dsieg¹²	dsieg¹²
mi²+dsíg²	V;IPFV;SG;1;PRS	mi²+dsig³	mi²+dsig
hnáɁ²	V;IPFV;SG;1;PRS	hnaɁ³	hnaɁ¹
huúɁ²	V;IPFV;SG;1;PRS	huuɁ¹²	huuɁ¹
ɁiéiɁ¹²	V;IPFV;SG;1;PRS	ɁieiɁ¹²	ɁieiɁ¹²
ti²+dsǿ²	V;IPFV;SG;1;PRS	ti²+dsø³	ti²+dsø
chiag¹²	V;IPFV;SG;1;PRS	chiag¹²	chiag¹²
káiɁ¹²	V;IPFV;SG;1;PRS	kaiɁ¹²	kaiɁ¹²
chi²+hné¹	V;IPFV;SG;1;PRS	chi²+hne³	chi²+hne
guen¹²	V;IPFV;SG;1;PRS	guen³	guen¹²
mi²+hǿ²	V;IPFV;SG;1;PRS	mi²+hø³	mi²+hø³
hmáɁ² (dsǿa¹²)	V;IPFV;SG;1;PRS	hmaɁ¹³	hmaɁ¹³¹²³¹¹
tónɁ² (huu¹²)	V;IPFV;SG;1;PRS	tonɁ¹²	tonɁ¹²¹²³³
hogɁ¹²	V;IPFV;SG;1;PRS	hogɁ¹²	hogɁ¹²
mi²+kánɁ²	V;IPFV;SG;1;PRS	mi²+kanɁ³	mi²+kanɁ
Ɂuan¹²	V;IPFV;SG;1;PRS	Ɂuan¹³	Ɂuan¹³
kēnɁ¹²	V;IPFV;SG;1;PRS	kēnɁ²	kēnɁ¹²
dsióɁ¹²	V;IPFV;SG;1;PRS	dsioɁ³	dsioɁ³²
tsiɁ¹²	V;IPFV;SG;1;PRS	tsøɁ¹²	tsiɁ¹²
tsánɁ²	V;IPFV;SG;1;PRS	hmaɁ¹²	tsanɁ²
hlái²	V;IPFV;SG;1;PRS	hlai¹²	hlai¹
ɁnióɁ¹²	V;IPFV;SG;1;PRS	ɁnioɁ¹²	ɁnioɁ³²
ngiú²	V;IPFV;SG;1;PRS	ngiu²	ngiu²
lúg²	V;IPFV;SG;1;PRS	lug²	lug²²
tag¹²	V;IPFV;SG;1;PRS	tag¹²	tag¹²
ɁiánɁ²	V;IPFV;SG;1;PRS	ɁianɁ¹²	ɁianɁ¹
mi²+Ɂai¹	V;IPFV;SG;1;PRS	mi²+Ɂai¹	mi²+Ɂai
kiog¹²	V;IPFV;SG;1;PRS	kog²	kiog¹³
chi²+dsén²	V;IPFV;SG;1;PRS	chi²+dsen¹³	chi²+dse
hlán²	V;IPFV;SG;1;PRS	hlan³	hlan¹
u¹+lén²	V;IPFV;SG;1;PRS	u²+len¹³	u²+len¹
dsan²	V;IPFV;SG;1;PRS	dsan²	dsan¹
ɁónɁ²	V;IPFV;SG;1;PRS	ɁonɁ³	ɁonɁ¹
hliúg² (lag³ dsi³)	V;IPFV;SG;1;PRS	hliug¹²	hliug¹²e³³²((
hmáɁ² (ta³)	V;IPFV;SG;1;PRS	hmaɁ¹³	hmaɁ¹³¹²³
dsán²	V;IPFV;SG;1;PRS	dsan¹²	dsan¹
tiun¹²	V;IPFV;SG;1;PRS	tøng²	tiun²²
lø²+liúɁ²	V;IPFV;SG;1;PRS	lø²+liuɁ¹²	lø²+liuɁ
dsǿɁ²	V;IPFV;SG;1;PRS	dsøɁ¹²	dsøɁ¹
guian¹²	V;IPFV;SG;1;PRS	guian¹³	guian¹²
ti²+li¹	V;IPFV;SG;1;PRS	ti²+li³	ti²+li³
mi²+ngḗɁ¹	V;IPFV;SG;1;PRS	mi²+ngēɁ³	mi²+ngēɁ
Ɂien²	V;IPFV;SG;1;PRS	Ɂien²	Ɂien²
guiúnɁ¹²	V;IPFV;SG;1;PRS	guiunɁ¹²	guiunɁ¹
hngiíɁ²	V;IPFV;SG;1;PRS	hngieɁ¹²	hngieɁ¹
Ɂmǿi²	V;IPFV;SG;1;PRS	Ɂmai¹²	Ɂmøi¹
chi²+ngió²	V;IPFV;SG;1;PRS	chi²+ngio³	chi²+ngi
ti²+dsiog¹	V;IPFV;SG;1;PRS	ti²+dsiog³	ti²+dsio
hlég²	V;IPFV;SG;1;PRS	hleg²	hleg²
hné¹²	V;IPFV;SG;1;PRS	hnē³	hne¹²
gǿi¹²	V;IPFV;SG;1;PRS	gøi¹²	gøi¹²
tsón²	V;IPFV;SG;1;PRS	tson³	tson¹
chiog¹²	V;IPFV;SG;1;PRS	chiog²	chiog²²
mái¹²	V;IPFV;SG;1;PRS	mai¹²	mai¹²
kiáɁ²	V;IPFV;SG;1;PRS	kiaɁ¹³	kiaɁ¹
mi²+rø¹²	V;IPFV;SG;1;PRS	mi²+rø³	mi²+rø³
tiú²	V;IPFV;SG;1;PRS	tiu¹²	tiu¹²
dsogɁ¹²	V;IPFV;SG;1;PRS	dsogɁ¹²	dsogɁ¹²
kií¹²	V;IPFV;SG;1;PRS	kø¹²	kii¹²
kian¹²	V;IPFV;SG;1;PRS	kian¹³	kian¹³
mi²+hínɁ²	V;IPFV;SG;1;PRS	mi²+hinɁ³	mi²+hinɁ
Ɂngiéng¹²	V;IPFV;SG;1;PRS	Ɂngieng¹²	Ɂngieng¹
ɁnáɁ¹²	V;IPFV;SG;1;PRS	ɁnaɁ¹²	ɁnaɁ¹²
siég²	V;IPFV;SG;1;PRS	sieg²	sieg²
sianɁ¹²	V;IPFV;SG;1;PRS	sianɁ¹³	sianɁ¹²
tsén²	V;IPFV;SG;1;PRS	tsen³	tsen¹
búɁ¹²	V;IPFV;SG;1;PRS	buɁ¹²	buɁ¹²
mi²+hniang¹ ni³	V;IPFV;SG;1;PRS	mi²+hniang³	mi²+hniang³
tagɁ²	V;IPFV;SG;1;PRS	tagɁ¹²	tagɁ¹
kúgɁ²	V;IPFV;SG;1;PRS	kugɁ³	kugɁ¹
ɁngióɁ¹²	V;IPFV;SG;1;PRS	ɁngioɁ²	ɁngioɁ¹
Ɂma¹²	V;IPFV;SG;1;PRS	Ɂma¹²	Ɂma¹²
chiágɁ¹²	V;IPFV;SG;1;PRS	chiagɁ¹²	chiagɁ¹
tø²+kanɁ¹³	V;IPFV;SG;1;PRS	tø²+kanɁ¹³	tø²+kanɁ
ngáɁ¹²	V;IPFV;SG;1;PRS	ngaɁ¹²	ngaɁ¹²
mi²+Ɂliúg²	V;IPFV;SG;1;PRS	mi²+Ɂliug³	mi²+Ɂliu
tóɁ¹²	V;IPFV;SG;1;PRS	toɁ¹²	toɁ¹²
Ɂug¹²	V;IPFV;SG;1;PRS	Ɂug¹³	Ɂug¹²
hái¹²	V;IPFV;SG;1;PRS	hai¹²	hai¹²
ián²	V;IPFV;SG;1;PRS	ian¹²	ian¹²
hén²	V;IPFV;SG;1;PRS	hen²	hen¹²
mi²+Ɂan¹²	V;IPFV;SG;1;PRS	mi²+Ɂan¹³	mi²+Ɂan¹
dsēn¹²	V;IPFV;SG;1;PRS	dsēn¹³	dsēn¹³
hngieng¹²	V;IPFV;SG;1;PRS	hngieng³	hngieng³
pø²+hánɁ²	V;IPFV;SG;1;PRS	pø²+hanɁ¹²	pø²+hanɁ
mi²+kiín¹	V;IPFV;SG;1;PRS	mi²+kiin³	mi²+kiin
ié²	V;IPFV;SG;1;PRS	ie¹²	ie¹²
hønɁ¹²	V;IPFV;SG;1;PRS	hønɁ¹²	hønɁ¹²
gúg²	V;IPFV;SG;1;PRS	gog³	gug²²
kuǿɁ¹²	V;IPFV;SG;1;PRS	kuøɁ¹²	kuøɁ¹²
tiánɁ¹²	V;IPFV;SG;1;PRS	tanɁ¹²	tianɁ¹²
hnióɁ²	V;IPFV;SG;1;PRS	hnioɁ²	hnioɁ³
tsenɁ¹²	V;IPFV;SG;1;PRS	tsēnɁ²	tsenɁ¹²
guieng¹²	V;IPFV;SG;1;PRS	guieng¹²	guieng¹
Ɂe¹²	V;IPFV;SG;1;PRS	Ɂe¹²	Ɂe¹²³
nang¹²	V;IPFV;SG;1;PRS	nang¹²	nang¹²
kuénɁ²	V;IPFV;SG;1;PRS	kuenɁ³	kuenɁ³
chiángɁ¹²	V;IPFV;SG;1;PRS	chiangɁ³	chiangɁ³
mē¹²	V;IPFV;SG;1;PRS	mē¹²	mē¹²²
mi²+kiónɁ²	V;IPFV;SG;1;PRS	mi²+kionɁ³	mi²+kion
kiagɁ¹²	V;IPFV;SG;1;PRS	kiagɁ¹²	kiagɁ¹²
ɁmóɁ²	V;IPFV;SG;1;PRS	ɁmoɁ¹²	ɁmoɁ³
hniang²	V;IPFV;SG;1;PRS	hniang²	hniang²
tian¹	V;IPFV;SG;1;PRS	tian¹	tian¹
mi²+kán¹²	V;IPFV;SG;1;PRS	mi²+kan³	mi²+kan³
guiugɁ²	V;IPFV;SG;1;PRS	guiugɁ²	guiugɁ²
ɁmēɁ¹²	V;IPFV;SG;1;PRS	ɁmēɁ²	ɁmēɁ¹²
mi²+hní¹	V;IPFV;SG;1;PRS	mi²+hni³	mi²+hni
hngióɁ²	V;IPFV;SG;1;PRS	hngioɁ³	hngioɁ³
tsēnɁ¹²	V;IPFV;SG;1;PRS	tsēnɁ¹²	tsēnɁ¹²
ɁøɁ¹²	V;IPFV;SG;1;PRS	ɁøɁ¹²	ɁøɁ¹²
mḗɁ²	V;IPFV;SG;1;PRS	mēɁ³	mēɁ²²
kang²	V;IPFV;SG;1;PRS	kang¹²	kang¹
liúg²	V;IPFV;SG;1;PRS	log³	liug¹
hḗɁ²	V;IPFV;SG;1;PRS	hēɁ²	hēɁ²¹
kø²+hinɁ¹²	V;IPFV;SG;1;PRS	kø²+hinɁ³	kø²+hinɁ
guenɁ¹²	V;IPFV;SG;1;PRS	guenɁ²	guenɁ¹²
hénɁ¹²	V;IPFV;SG;1;PRS	henɁ¹³	henɁ¹²
Ɂen¹²	V;IPFV;SG;1;PRS	Ɂen²	Ɂen¹²
hnáɁ¹²	V;IPFV;SG;1;PRS	hnaɁ¹²	hnaɁ¹²
lánɁ²	V;IPFV;SG;1;PRS	lanɁ¹²	lanɁ¹
Ɂnie¹²	V;IPFV;SG;1;PRS	Ɂna³	Ɂnie¹²
ngie³	V;IPFV;SG;1;PRS	ngie³	ngie³
lióg¹²	V;IPFV;SG;1;PRS	log¹²	loog¹²
mi²+gan¹	V;IPFV;SG;1;PRS	mi²+gan¹	mi²+gan
kón²	V;IPFV;SG;1;PRS	kon³	kon¹²
Ɂnai¹²	V;IPFV;SG;1;PRS	Ɂnai¹²	Ɂnai¹²
hngió²	V;IPFV;SG;1;PRS	hngio¹²	hngio¹
chióg¹²	V;IPFV;SG;1;PRS	chiog³	chiog³²
Ɂme¹²	V;IPFV;SG;1;PRS	Ɂme²	Ɂme¹²
Ɂmóng¹²	V;IPFV;SG;1;PRS	Ɂmong¹²	Ɂmong¹²
mi²+hu¹	V;IPFV;SG;1;PRS	mi²+hu³	mi²+hu³
Ɂog¹²	V;IPFV;SG;1;PRS	Ɂog¹²	Ɂog¹²
kø¹²	V;IPFV;SG;1;PRS	kø¹²	kø¹²¹
Ɂia¹²	V;IPFV;SG;1;PRS	Ɂia¹²	Ɂia¹²
u¹+lian¹	V;IPFV;SG;1;PRS	u²+lian¹	u²+lian
bø²+lḗnɁ²	V;IPFV;SG;1;PRS	bø²+lēnɁ²	bø²+lēnɁ
mi²+dsian¹²	V;IPFV;SG;1;PRS	mi²+dsian¹³	mi²+dsian
kēn²	V;IPFV;SG;1;PRS	kēn³	kēn³²
chiúg²	V;IPFV;SG;1;PRS	chiug¹²	chiug¹
ɁánɁ²	V;IPFV;SG;1;PRS	ɁanɁ¹²	ɁanɁ¹
tiúg²	V;IPFV;SG;1;PRS	tiug¹²	tiug¹
guu²+dsḗn¹³	V;IPFV;SG;1;PRS	guu²+dsēn¹³	guu²+dsēn
guiánɁ¹²	V;IPFV;SG;1;PRS	guianɁ¹²	guianɁ¹
hniá¹²	V;IPFV;SG;1;PRS	hnia¹²	hnia¹²
hlíɁ¹²	V;IPFV;SG;1;PRS	hløɁ¹²	hliɁ¹²
Ɂí²	V;IPFV;SG;1;PRS	Ɂu¹²	Ɂu¹²
ɁlieɁ¹²	V;IPFV;SG;1;PRS	ɁlieɁ¹²	ɁlieɁ¹²
huen¹²	V;IPFV;SG;1;PRS	huen¹³	huen¹³
ieg¹²	V;IPFV;SG;1;PRS	øg¹²	øgg²²
hog¹²	V;IPFV;SG;1;PRS	hog¹²	hog¹²
køgɁ²	V;IPFV;SG;1;PRS	køgɁ¹²	køgɁ¹
lan²	V;IPFV;SG;1;PRS	lan²	lan¹²
tsá¹²	V;IPFV;SG;1;PRS	tsa¹²	tsa¹²
siog²	V;IPFV;SG;1;PRS	siog²	siog²
huu¹²	V;IPFV;SG;1;PRS	huu¹²	huu¹²
tsíɁ¹²	V;IPFV;SG;1;PRS	tsiɁ³	tsiɁ¹²
Ɂéng²	V;IPFV;SG;1;PRS	Ɂeng¹²	Ɂeng¹
tan¹³	V;IPFV;SG;1;PRS	tan¹³	tan¹³
ɁiíɁ²	V;IPFV;SG;1;PRS	ɁiiɁ¹²	ɁiiɁ¹
hnóɁ²	V;IPFV;SG;1;PRS	hnoɁ¹²	hnoɁ¹
Ɂán¹² ɁogɁ¹²	V;IPFV;SG;1;PRS	Ɂan¹²	Ɂan¹²³¹³¹
gúɁ¹²	V;IPFV;SG;1;PRS	guɁ¹²	guɁ¹²
kánɁ¹²	V;IPFV;SG;1;PRS	kanɁ¹³	kanɁ¹²
kionɁ¹²	V;IPFV;SG;1;PRS	kionɁ¹²	kionɁ¹²
Ɂai¹²	V;IPFV;SG;1;PRS	Ɂai¹²	Ɂai¹²
dsi²	V;IPFV;SG;1;PRS	dsi¹²	dsi¹²
mi²+dsiagɁ¹	V;IPFV;SG;1;PRS	mi²+dsiagɁ³	mi²+dsiag
mi²+ti¹	V;IPFV;SG;1;PRS	mi²+ti³	mi²+ti³
ngēɁ²	V;IPFV;SG;1;PRS	ngēɁ²	ngēɁ¹
tógɁ¹²	V;IPFV;SG;1;PRS	togɁ¹²	togɁ¹²
mi²+liág¹	V;IPFV;SG;1;PRS	mi²+liag¹³	mi²+liag
guuɁ¹²	V;IPFV;SG;1;PRS	guuɁ²	guuɁ²²
ɁlianɁ¹²	V;IPFV;SG;1;PRS	ɁlianɁ¹²	ɁlianɁ¹
dsanɁ¹²	V;IPFV;SG;1;PRS	dsanɁ¹²	dsanɁ¹²
téiɁ²	V;IPFV;SG;1;PRS	teiɁ¹²	teiɁ¹
neɁ¹²	V;IPFV;SG;1;PRS	neɁ³	neɁ³¹
mi²+gag¹²	V;IPFV;SG;1;PRS	mi²+gag¹³	mi²+gag¹
høn¹²	V;IPFV;SG;1;PRS	høn¹²	høn¹²
hógɁ¹²	V;IPFV;SG;1;PRS	guiogɁ¹²	hogɁ¹²
mi²+dsē¹²	V;IPFV;SG;1;PRS	mi²+dsē¹³	mi²+dsē¹
nǿɁ²	V;IPFV;SG;1;PRS	nøɁ¹²	nøɁ³¹
hngiú²	V;IPFV;SG;1;PRS	hngiu¹²	hngiu¹
tei²	V;IPFV;SG;1;PRS	tei³	tei³²
hiúɁ²	V;IPFV;SG;1;PRS	hioɁ³	hiuɁ³
dsén²	V;IPFV;SG;1;PRS	dsen²	dsen¹
ɁiuɁ³ (ɁéɁ¹)	V;IPFV;SG;1;PRS	ɁiuɁ³	ɁiuɁ³³²¹³
ɁiúɁ¹²	V;IPFV;SG;1;PRS	ɁiuɁ³	ɁiuɁ³²
hǿa¹²	V;IPFV;SG;1;PRS	høa¹²	høa¹²
hlǿ²	V;IPFV;SG;1;PRS	hlø¹²	hlø¹²
ti²+dsøa¹²	V;IPFV;SG;1;PRS	ti²+dsøa²	ti²+dsøa
len¹² dsǿa¹²	V;IPFV;SG;1;PRS	len¹²	len¹²Ɂ³¹¹
tson¹²	V;IPFV;SG;1;PRS	tson¹²	tson¹³
Ɂøin¹²	V;IPFV;SG;1;PRS	Ɂøin²	Ɂøin²²
dsióɁ¹² hǿg³	V;IPFV;SG;1;PRS	dsioɁ¹²	dsioɁ¹²¹³
chi²+láɁ²	V;IPFV;SG;1;PRS	chi²+laɁ¹²	chi²+laɁ
hai¹²	V;IPFV;SG;1;PRS	hai¹²	hai¹²
tanɁ¹²	V;IPFV;SG;1;PRS	tanɁ²	tanɁ¹²
siúɁ²	V;IPFV;SG;1;PRS	siuɁ¹²	siuɁ³
ɁnangɁ²	V;IPFV;SG;1;PRS	ɁnangɁ¹²	ɁnangɁ¹
hlian¹²	V;IPFV;SG;1;PRS	hlian¹²	hlian¹²
tion¹²	V;IPFV;SG;1;PRS	ton¹²	tion¹³
chiógɁ² ( hmøi²)	V;IPFV;SG;1;PRS	chiogɁ³	chiogɁ³³Ɂ¹²(
Ɂlí²	V;IPFV;SG;1;PRS	Ɂli¹²	Ɂli¹²
húg²	V;IPFV;SG;1;PRS	hug²	hug²³
ɁlogɁ²	V;IPFV;SG;1;PRS	ɁlogɁ²	ɁlogɁ¹
siág¹²	V;IPFV;SG;1;PRS	siog³	siag¹²
dsiog¹²	V;IPFV;SG;1;PRS	dsiog³	dsiog²²
ɁløaɁ¹²	V;IPFV;SG;1;PRS	ɁløaɁ³	ɁløaɁ²²
Ɂiá¹²	V;IPFV;SG;1;PRS	Ɂia¹³	Ɂia¹²
chiínɁ²	V;IPFV;SG;1;PRS	hmaɁ¹²	hmaɁ¹²³
dsúgɁ¹²	V;IPFV;SG;1;PRS	dsugɁ¹²	dsugɁ¹²
héi²	V;IPFV;SG;1;PRS	hi²	hei¹²
hnia¹²	V;IPFV;SG;1;PRS	hnia¹²	hnia¹²
mi²+tián² (dsǿa¹²)	V;IPFV;SG;1;PRS	mi²+tian³	mi²+tian³¹³((
u²+nio¹³	V;IPFV;SG;1;PRS	u²+nio¹²	u²+nio¹
mi²+Ɂog¹³	V;IPFV;SG;1;PRS	mi²+Ɂog³	mi²+Ɂog³
dsiánɁ²	V;IPFV;SG;1;PRS	dsianɁ³	dsianɁ³
lēɁ²	V;IPFV;SG;1;PRS	lēɁ³	lēɁ³²
tsø²+nióɁ²	V;IPFV;SG;1;PRS	tsø²+nioɁ³	tsø²+nio
kuú²	V;IPFV;SG;1;PRS	kuu²	kuu²³
kon¹²	V;IPFV;SG;1;PRS	kon¹²	kon¹²
bḗn²	V;IPFV;SG;1;PRS	bēn¹²	bēn¹²
mi²+hlēnɁ¹	V;IPFV;SG;1;PRS	mi²+hlēnɁ³	mi²+hlēn
hmo¹²	V;IPFV;SG;1;PRS	hmo¹²	hmo¹²
tei¹²	V;IPFV;SG;1;PRS	tei¹²	tei¹²
mi²+hniang¹ dsǿa¹²	V;IPFV;SG;1;PRS	mi²+hniang³	mi²+hniang³((
huánɁ¹²	V;IPFV;SG;1;PRS	huanɁ¹²	huanɁ¹²
ɁuanɁ¹²	V;IPFV;SG;1;PRS	ɁuanɁ¹²	ɁuanɁ¹²
rang¹²	V;IPFV;SG;1;PRS	rang¹²	rang¹²
hínɁ¹²	V;IPFV;SG;1;PRS	hinɁ³	hinɁ³²
hiég²	V;IPFV;SG;1;PRS	hieg¹²	hieg¹
ɁéɁ¹²	V;IPFV;SG;1;PRS	ɁeɁ¹²	ɁeɁ¹²
gḗɁ²	V;IPFV;SG;1;PRS	gēɁ²	gēɁ²²
ɁagɁ²	V;IPFV;SG;1;PRS	ɁagɁ³	ɁagɁ³
ɁmiɁ¹²	V;IPFV;SG;1;PRS	ɁmiɁ³	ɁmiɁ¹²
háng¹²	V;IPFV;SG;1;PRS	hang³	hang¹²
nung²	V;IPFV;SG;1;PRS	nung¹²	nung¹
kḗn²	V;IPFV;SG;1;PRS	kēn²	kēn²¹
u²+Ɂai¹²	V;IPFV;SG;1;PRS	u²+Ɂai¹²	u²+Ɂai¹
ngo²	V;IPFV;SG;1;PRS	ngo²	ngo¹²
chi²+ngiú²	V;IPFV;SG;1;PRS	chi²+ngiu³	chi²+ngi
lø²+liugɁ³	V;IPFV;SG;1;PRS	lø²+liugɁ³	lø²+liug
dsen¹²	V;IPFV;SG;1;PRS	dsen¹²	dsen¹²
tsáiɁ¹²	V;IRR;SG;1;FUT	huøi³	tsaiɁ³³
kø²+káng¹²	V;IRR;SG;1;FUT	kø¹+kang¹³	kø¹+kang
guiágɁ¹²	V;IRR;SG;1;FUT	guiagɁ¹³	guiagɁ¹
bø²+hmé²	V;IRR;SG;1;FUT	bø¹+hme³	bø¹+hme
dsánɁ¹²	V;IRR;SG;1;FUT	dsianɁ¹²	dsanɁ³³
lǿɁ²	V;IRR;SG;1;FUT	lig²	løɁ¹³
tií²	V;IRR;SG;1;FUT	tii¹³	tii¹³
guiénɁ²	V;IRR;SG;1;FUT	guienɁ¹³	guienɁ¹
héinɁ¹²	V;IRR;SG;1;FUT	heinɁ³	heinɁ¹³
mi²+kionɁ¹	V;IRR;SG;1;FUT	mi¹+kionɁ¹³	mi¹+kion
hénɁ²	V;IRR;SG;1;FUT	henɁ³	henɁ¹
chi²+dsán²	V;IRR;SG;1;FUT	chi¹+dsan³	chi¹+dsa
guiúg²	V;IRR;SG;1;FUT	guiug³	guiug¹
Ɂon¹²	V;IRR;SG;1;FUT	Ɂon¹³	Ɂon¹³
niá¹²	V;IRR;SG;1;FUT	nia¹	nia¹³
tangɁ²	V;IRR;SG;1;FUT	tangɁ¹³	tangɁ¹
Ɂan¹²	V;IRR;SG;1;FUT	Ɂan¹³	Ɂan¹³
dság¹²	V;IRR;SG;1;FUT	dsag¹³	dsag¹³
hmóngɁ¹²	V;IRR;SG;1;FUT	hmongɁ¹³	hmongɁ¹
tsanɁ¹²	V;IRR;SG;1;FUT	huanɁ³	tsanɁ¹³
tánɁ¹²	V;IRR;SG;1;FUT	tanɁ¹³	tanɁ³³
kuøin¹²	V;IRR;SG;1;FUT	kuøin³	kuøin¹³
gógɁ¹²	V;IRR;SG;1;FUT	gogɁ¹	gogɁ¹³
tsø²+nióɁ¹²	V;IRR;SG;1;FUT	tsø¹+nioɁ¹	tsø¹+nioɁ
mi²+hénɁ²	V;IRR;SG;1;FUT	mi¹+henɁ³	mi¹+henɁ
ti²+líɁ¹	V;IRR;SG;1;FUT	ti¹+lei2¹	ti¹+lei
hánɁ¹²	V;IRR;SG;1;FUT	hanɁ¹	hanɁ¹³
ɁúgɁ²	V;IRR;SG;1;FUT	ɁogɁ³	ɁugɁ³
tieɁ¹²	V;IRR;SG;1;FUT	taɁ¹³	tieɁ³³
hiúg²	V;IRR;SG;1;FUT	hiug³	hiug³
hinɁ³	V;IRR;SG;1;FUT	hinɁ¹	hinɁ¹
tian¹²	V;IRR;SG;1;FUT	tian¹	tian¹¹
mi²+hmḗ²	V;IRR;SG;1;FUT	mi¹+hmē³	mi¹+hmē
ngē¹²	V;IRR;SG;1;FUT	ngē¹³	ngē¹³
ngái¹²	V;IRR;SG;1;FUT	ngai³	ngai³³
tión²	V;IRR;SG;1;FUT	ton³	tion³
tsø²+kuenɁ¹²	V;IRR;SG;1;FUT	tsø¹+kuenɁ¹²	tsø¹+kuenɁ
Ɂøa¹²	V;IRR;SG;1;FUT	Ɂøa¹³	Ɂøa¹³
hngiáɁ²	V;IRR;SG;1;FUT	hngiaɁ³	hngiaɁ³
ngioɁ¹²	V;IRR;SG;1;FUT	ngioɁ³	ngioɁ³¹
ngøa¹²	V;IRR;SG;1;FUT	ngøa¹³	ngøa³³
ɁlianɁ²	V;IRR;SG;1;FUT	ɁlianɁ¹	ɁlianɁ¹
guiú²	V;IRR;SG;1;FUT	guiu¹³	guiu¹
ta¹²	V;IRR;SG;1;FUT	ta¹³	ta¹³³
rónɁ¹²	V;IRR;SG;1;FUT	rang¹	ronɁ¹³
kúgɁ¹²	V;IRR;SG;1;FUT	kugɁ¹³	kugɁ³³
nioɁ²	V;IRR;SG;1;FUT	nioɁ¹	nioɁ¹
huúɁ¹²	V;IRR;SG;1;FUT	huuɁ³	huuɁ³³
kágɁ¹²	V;IRR;SG;1;FUT	kagɁ³	kagɁ¹³
guái²	V;IRR;SG;1;FUT	guai¹³	guai¹
hḗnɁ²	V;IRR;SG;1;FUT	hēnɁ¹³	hēnɁ¹
mi²+hnia¹²	V;IRR;SG;1;FUT	mi¹+hnia¹³	mi¹+hnia
chi²+kián²	V;IRR;SG;1;FUT	chi¹+kian³	chi¹+kia
hian¹²	V;IRR;SG;1;FUT	han³	hian¹³
ku² hmo¹²	V;IRR;SG;1;FUT	ku¹³	ku¹³n³²³
kión²	V;IRR;SG;1;FUT	kion³	kion³
téiɁ¹²	V;IRR;SG;1;FUT	teiɁ¹³	teiɁ³³
hnḗɁ²	V;IRR;SG;1;FUT	hnēɁ³	hnēɁ³
ngē²	V;IRR;SG;1;FUT	ngie¹	ngē¹³
mi²+ɁḗɁ²	V;IRR;SG;1;FUT	mi¹+ɁēɁ³	mi¹+ɁēɁ
tø²+ɁénɁ¹²	V;IRR;SG;1;FUT	tø¹+ɁenɁ³	tø¹+ɁenɁ
uénɁ²	V;IRR;SG;1;FUT	uenɁ²	uenɁ²
rón²	V;IRR;SG;1;FUT	ron³	ron³¹
Ɂo¹²	V;IRR;SG;1;FUT	Ɂo¹³	Ɂo¹³³
hǿɁ²	V;IRR;SG;1;FUT	høɁ¹³	høɁ¹³
tai²	V;IRR;SG;1;FUT	tai³	tai¹³
mi²+tan¹³	V;IRR;SG;1;FUT	mi¹+tan¹³	mi¹+tan¹
ɁuǿɁ¹²	V;IRR;SG;1;FUT	ɁuøɁ¹³	ɁuøɁ¹³
guønɁ¹²	V;IRR;SG;1;FUT	guønɁ¹	guønɁ¹¹
kán²	V;IRR;SG;1;FUT	kan¹³	kan¹³
háinɁ¹²	V;IRR;SG;1;FUT	hainɁ¹³	hainɁ¹³
dsø²+huen¹³	V;IRR;SG;1;FUT	dsø¹+huen¹³	dsø¹+huen
lag²	V;IRR;SG;1;FUT	lag¹³	lag¹³
kiúgɁ²	V;IRR;SG;1;FUT	kiugɁ³	kiugɁ³
huú²	V;IRR;SG;1;FUT	huø¹³	huu¹³
mi²+Ɂnio¹	V;IRR;SG;1;FUT	mi¹+Ɂnio¹	mi¹+Ɂnio
bán²	V;IRR;SG;1;FUT	ban¹³	ban¹³
kiuɁ¹²	V;IRR;SG;1;FUT	kiuɁ¹³	kiuɁ¹³
mi²+gug¹	V;IRR;SG;1;FUT	mi¹+gug¹	mi¹+gug
rǿnɁ¹²	V;IRR;SG;1;FUT	rønɁ³	rønɁ³³
lán¹²	V;IRR;SG;1;FUT	len²	lan¹³
Ɂno¹²	V;IRR;SG;1;FUT	Ɂno¹³	Ɂno¹³
mi²+kien¹²	V;IRR;SG;1;FUT	mi¹+kien¹³	mi¹+kien
chióɁ¹²	V;IRR;SG;1;FUT	chioɁ³	chioɁ³³
ngiéɁ¹²	V;IRR;SG;1;FUT	ngieɁ³	ngieɁ¹³
siúg²	V;IRR;SG;1;FUT	siug³	siug³
huánɁ²	V;IRR;SG;1;FUT	huanɁ¹³	huanɁ³
dsiag¹²	V;IRR;SG;1;FUT	dsiag¹³	dsiag¹³
teng¹²	V;IRR;SG;1;FUT	tøng¹³	teng¹³
guiónɁ²	V;IRR;SG;1;FUT	guionɁ³	guionɁ¹
mi²+kon¹²	V;IRR;SG;1;FUT	mi¹+kon³	mi¹+kon³
hanɁ¹² dsǿa¹²	V;IRR;SG;1;FUT	hanɁ¹	hanɁ¹³²³¹³
méɁ²	V;IRR;SG;1;FUT	meɁ¹³	meɁ¹³
ngié²	V;IRR;SG;1;FUT	ngie²	ngie¹
tsogɁ² hmøi²	V;IRR;SG;1;FUT	tsogɁ¹	tsogɁ¹¹³³²
ɁnáiɁ¹²	V;IRR;SG;1;FUT	ɁnaiɁ¹³	ɁnaiɁ¹³
hnio³	V;IRR;SG;1;FUT	hnio¹	hnio¹
Ɂngio¹²	V;IRR;SG;1;FUT	Ɂngio¹³	Ɂngio¹³
ténɁ¹²	V;IRR;SG;1;FUT	tenɁ³	tenɁ³³
guǿn¹²	V;IRR;SG;1;FUT	guøn¹³	guøn¹³
hen¹²	V;IRR;SG;1;FUT	hen³	hen³³
hián²	V;IRR;SG;1;FUT	hian¹³	hian¹
huǿin¹²	V;IRR;SG;1;FUT	huøin¹³	huøin¹³
tsón¹²	V;IRR;SG;1;FUT	tson¹	tson³³
hngia¹²	V;IRR;SG;1;FUT	han¹³	han¹³¹³
dsoɁ²	V;IRR;SG;1;FUT	dsioɁ¹	dsoɁ¹
Ɂán²	V;IRR;SG;1;FUT	Ɂan³	Ɂan¹³
køn¹²	V;IRR;SG;1;FUT	køn¹³	køn¹³
Ɂiog²	V;IRR;SG;1;FUT	Ɂiog¹	Ɂiog¹
tsog²	V;IRR;SG;1;FUT	tsog¹	tsog¹
mi²+tsḗn¹	V;IRR;SG;1;FUT	mi¹+tsēn¹³	mi¹+tsēn
kugɁ¹²	V;IRR;SG;1;FUT	kugɁ¹³	kugɁ¹³
tsǿaɁ¹²	V;IRR;SG;1;FUT	huøɁ¹³	huøa¹³³
hne¹²	V;IRR;SG;1;FUT	hnøa¹³	hne¹³
tsǿng²	V;IRR;SG;1;FUT	tsøng¹³	tsøng¹
hág¹²	V;IRR;SG;1;FUT	hag¹³	hag¹³
hmóɁ¹²	V;IRR;SG;1;FUT	hmoɁ³	hmoɁ³³
hngie¹²	V;IRR;SG;1;FUT	han³	han³e¹³
nēɁ¹²	V;IRR;SG;1;FUT	nēɁ¹³	nēɁ¹³
húɁ²	V;IRR;SG;1;FUT	huɁ³	huɁ¹³
mi²+dsiog¹	V;IRR;SG;1;FUT	mi¹+dsiog¹	mi¹+dsio
Ɂnia¹²	V;IRR;SG;1;FUT	Ɂnia¹³	Ɂnia¹³
héin¹²	V;IRR;SG;1;FUT	hein³	hein¹³
dsúgɁ²	V;IRR;SG;1;FUT	dsugɁ³	dsugɁ³
ngie¹²	V;IRR;SG;1;FUT	ngie¹³	ngie¹³
dsiánɁ¹²	V;IRR;SG;1;FUT	dsianɁ¹³	dsianɁ¹
mi²+tan¹²	V;IRR;SG;1;FUT	mi¹+tan³	mi¹+tan³
køin²	V;IRR;SG;1;FUT	køin¹³	køin¹
chiáng¹²	V;IRR;SG;1;FUT	chiang¹³	chiang¹
ɁēnɁ¹²	V;IRR;SG;1;FUT	ɁēnɁ³	ɁēnɁ³³
kióɁ¹²	V;IRR;SG;1;FUT	kioɁ³	kioɁ³³
Ɂlúg²	V;IRR;SG;1;FUT	Ɂliug²	Ɂlug³
møa¹²	V;IRR;SG;1;FUT	møa¹³	møa¹³
gǿaɁ¹²	V;IRR;SG;1;FUT	gøaɁ¹³	gøaɁ³³
tug	V;IRR;SG;1;FUT	tiug¹²	tiug
hngēɁ¹²	V;IRR;SG;1;FUT	hngēɁ³	hngēɁ³¹
dsie¹²	V;IRR;SG;1;FUT	dsie¹³	dsie¹³
tsénɁ²	V;IRR;SG;1;FUT	tsēnɁ³	tsenɁ¹
chiunɁ¹²	V;IRR;SG;1;FUT	chiunɁ³	chiunɁ³
Ɂméi¹²	V;IRR;SG;1;FUT	Ɂmei³	Ɂmei³³
tióɁ¹²	V;IRR;SG;1;FUT	tiag¹	tioɁ³¹
kug²	V;IRR;SG;1;FUT	kug¹	kug¹³
mi²+Ɂlí¹	V;IRR;SG;1;FUT	mi¹+Ɂli³	mi¹+Ɂli
dsen³ (kaɁ³)	V;IRR;SG;1;FUT	dsen³	dsen³³¹²³¹
chiogɁ¹²	V;IRR;SG;1;FUT	chiogɁ¹	chiogɁ¹
chi²+méɁ²	V;IRR;SG;1;FUT	chi¹+meɁ¹³	chi¹+meɁ
hánɁ²	V;IRR;SG;1;FUT	hanɁ¹³	hanɁ¹
tsø²+kuønɁ¹²	V;IRR;SG;1;FUT	tsø¹+kuønɁ¹²	tsø¹+kuønɁ
uǿi²	V;IRR;SG;1;FUT	uøi³	uøi³²
mi²+kuuɁ¹²	V;IRR;SG;1;FUT	mi¹+kuuɁ¹³	mi¹+kuuɁ
tø²+gugɁ¹²	V;IRR;SG;1;FUT	tø¹+gugɁ¹³	tø¹+gugɁ
mi²+hlíɁ²	V;IRR;SG;1;FUT	mi¹+hliɁ³	mi¹+hliɁ
mi²+níɁ¹	V;IRR;SG;1;FUT	mi¹+niɁ³	mi¹+niɁ
búɁ²	V;IRR;SG;1;FUT	buɁ¹³	buɁ¹³
hngiángɁ¹²	V;IRR;SG;1;FUT	hngiangɁ³	hngiangɁ
tsø²+han¹²	V;IRR;SG;1;FUT	tsø¹+han¹	tsø¹+han
ngai¹²	V;IRR;SG;1;FUT	ngai³	ngai³³
chión²	V;IRR;SG;1;FUT	chion³	chion³
guianɁ¹²	V;IRR;SG;1;FUT	guianɁ¹	guianɁ¹
Ɂiog¹²	V;IRR;SG;1;FUT	Ɂog¹³	Ɂiog¹¹
mi²+dsíg²	V;IRR;SG;1;FUT	mi¹+dsig³	mi¹+dsig
tǿɁ²	V;IRR;SG;1;FUT	tøa¹³	tøɁ¹³
hnáɁ²	V;IRR;SG;1;FUT	hnaɁ³	hnaɁ¹
ngøɁ¹²	V;IRR;SG;1;FUT	ngøɁ³	ngøɁ³³
huúɁ²	V;IRR;SG;1;FUT	huuɁ¹³	huuɁ³
lieɁ¹²	V;IRR;SG;1;FUT	laɁ³	lieɁ¹³
ɁiéiɁ¹²	V;IRR;SG;1;FUT	ɁieiɁ¹³	ɁieiɁ¹³
guen¹²	V;IRR;SG;1;FUT	guen³	guen¹³
mi²+hǿ²	V;IRR;SG;1;FUT	mi¹+hø³	mi¹+hø³
hmáɁ² (dsǿa¹²)	V;IRR;SG;1;FUT	hmaɁ¹³	hmaɁ¹³³³¹³g
tónɁ² (huu¹²)	V;IRR;SG;1;FUT	tonɁ¹³	tonɁ¹³³³¹³
tanɁ²	V;IRR;SG;1;FUT	tianɁ¹	tanɁ¹
mi²+kánɁ²	V;IRR;SG;1;FUT	mi¹+kanɁ³	mi¹+kanɁ
Ɂuan¹²	V;IRR;SG;1;FUT	Ɂuan¹³	Ɂuan¹³
Ɂúg²	V;IRR;SG;1;FUT	Ɂug¹³	Ɂug¹³
kēnɁ¹²	V;IRR;SG;1;FUT	kēnɁ³	kēnɁ³³
dsióɁ¹²	V;IRR;SG;1;FUT	dsioɁ¹³	dsioɁ³³
tsiɁ¹²	V;IRR;SG;1;FUT	tsøɁ¹³	tsiɁ¹³
kiéɁ¹²	V;IRR;SG;1;FUT	kieɁ³	kieɁ³³
bén²	V;IRR;SG;1;FUT	ben¹³	ben¹³
hlái²	V;IRR;SG;1;FUT	hlai¹³	hlai¹
ɁnióɁ¹²	V;IRR;SG;1;FUT	ɁnioɁ¹³	ɁnioɁ¹³
ngiú²	V;IRR;SG;1;FUT	ngiu³	ngiu³
tag¹²	V;IRR;SG;1;FUT	tag¹³	tag¹³
mi²+Ɂai¹	V;IRR;SG;1;FUT	mi¹+Ɂai¹	mi¹+Ɂai
tsí¹²	V;IRR;SG;1;FUT	tsi¹³	tsi¹³
chi²+dsén²	V;IRR;SG;1;FUT	chi¹+dsen¹³	chi¹+dse
hlán²	V;IRR;SG;1;FUT	hlan³	hlan¹
u¹+lén²	V;IRR;SG;1;FUT	u¹+len¹³	u¹+len¹
tsen¹²	V;IRR;SG;1;FUT	tsēn³	tsen¹³
dsan²	V;IRR;SG;1;FUT	dsian¹	dsan¹
ɁónɁ²	V;IRR;SG;1;FUT	ɁonɁ³	ɁonɁ¹
hliúg² (lag³ dsi³)	V;IRR;SG;1;FUT	hliug¹³	hliug¹³²³¹((((
hmáɁ² (ta³)	V;IRR;SG;1;FUT	hmaɁ¹³	hmaɁ¹³³²¹
dsán²	V;IRR;SG;1;FUT	dsan¹³	dsan¹
tiun¹²	V;IRR;SG;1;FUT	tøng³	tiun³³
lø²+liúɁ²	V;IRR;SG;1;FUT	lø¹+liuɁ¹³	lø¹+liuɁ
ha¹²	V;IRR;SG;1;FUT	ha¹³	ha¹³¹
guian¹²	V;IRR;SG;1;FUT	guian¹³	guian¹³
ti²+li¹	V;IRR;SG;1;FUT	ti¹+li³	ti¹+li³
mi²+ngḗɁ¹	V;IRR;SG;1;FUT	mi¹+ngēɁ³	mi¹+ngēɁ
Ɂien²	V;IRR;SG;1;FUT	Ɂien¹	Ɂien¹
guiúnɁ¹²	V;IRR;SG;1;FUT	guiunɁ¹³	guiunɁ¹
mi²+kuen¹²	V;IRR;SG;1;FUT	mi¹+kuen¹³	mi¹+kuen
hngiíɁ²	V;IRR;SG;1;FUT	hngieɁ¹³	hngieɁ¹
mi²+gǿg¹	V;IRR;SG;1;FUT	mi¹+gøg¹	mi¹+gøg
kanɁ¹²	V;IRR;SG;1;FUT	kanɁ¹³	kanɁ¹³
Ɂmǿi²	V;IRR;SG;1;FUT	Ɂmai¹³	Ɂmai¹
chi²+ngió²	V;IRR;SG;1;FUT	chi¹+ngio³	chi¹+ngi
ti²+dsiog¹	V;IRR;SG;1;FUT	ti¹+dsiog³	ti¹+dsio
Ɂnē¹²	V;IRR;SG;1;FUT	Ɂnē¹³	Ɂnē¹³
Ɂngieng¹²	V;IRR;SG;1;FUT	Ɂngieng¹³	Ɂngieng³
dsii²+lian¹	V;IRR;SG;1;FUT	dsii¹+lian¹	dsii¹+lia
tsón²	V;IRR;SG;1;FUT	tson³	tson³
chiog¹²	V;IRR;SG;1;FUT	chiog³	chiog³³
húgɁ²	V;IRR;SG;1;FUT	hogɁ¹³	hugɁ¹
kiáɁ²	V;IRR;SG;1;FUT	kiaɁ¹³	kiaɁ¹
mi²+rø¹²	V;IRR;SG;1;FUT	mi¹+rø³	mi¹+rø³
tiú²	V;IRR;SG;1;FUT	tiu¹³	tiu¹³
hiugɁ¹²	V;IRR;SG;1;FUT	hiugɁ³	hiugɁ³³
kií¹²	V;IRR;SG;1;FUT	kø¹³	kii¹³
kian¹²	V;IRR;SG;1;FUT	kian³	kian¹³
Ɂngiéng¹²	V;IRR;SG;1;FUT	Ɂngieng¹³	Ɂngieng¹
ɁnáɁ¹²	V;IRR;SG;1;FUT	ɁnaɁ¹³	ɁnaɁ¹³
siég²	V;IRR;SG;1;FUT	sieg³	sieg³
nió²	V;IRR;SG;1;FUT	nio¹³	nio¹³
kien¹²	V;IRR;SG;1;FUT	kien¹³	kien¹³
tsén²	V;IRR;SG;1;FUT	tsen³	tsen³
búɁ¹²	V;IRR;SG;1;FUT	buɁ¹³	buɁ¹³
Ɂuan²	V;IRR;SG;1;FUT	Ɂuen³	Ɂuan¹
mi²+guionɁ¹	V;IRR;SG;1;FUT	mi¹+guionɁ³	mi¹+guion
tagɁ²	V;IRR;SG;1;FUT	tagɁ¹³	tagɁ¹
kúgɁ²	V;IRR;SG;1;FUT	kugɁ³	kugɁ¹
chiágɁ¹²	V;IRR;SG;1;FUT	chiagɁ¹³	chiagɁ¹
tø²+kanɁ¹³	V;IRR;SG;1;FUT	tø¹+kanɁ¹³	tø¹+kanɁ
hiégɁ¹²	V;IRR;SG;1;FUT	hiegɁ¹³	hiegɁ¹³
ngáɁ¹²	V;IRR;SG;1;FUT	ngaɁ¹³	ngaɁ¹³
tóɁ¹²	V;IRR;SG;1;FUT	toɁ¹³	toɁ¹³
tanɁ¹² huu¹²	V;IRR;SG;1;FUT	tanɁ³	tanɁ³³¹³³³
Ɂug¹²	V;IRR;SG;1;FUT	Ɂug¹³	Ɂug¹³
hái¹²	V;IRR;SG;1;FUT	hai¹³	hai¹³
dsēn¹²	V;IRR;SG;1;FUT	dsēn¹³	dsēn¹³
hiúgɁ²	V;IRR;SG;1;FUT	hiugɁ³	hiugɁ³
hngieng¹²	V;IRR;SG;1;FUT	hngieng³	hngieng³
tsai¹²	V;IRR;SG;1;FUT	tsai³	tsai³³
pø²+hánɁ²	V;IRR;SG;1;FUT	pø¹+hanɁ¹³	pø¹+hanɁ
lá¹²	V;IRR;SG;1;FUT	la³	la¹³¹
bí²	V;IRR;SG;1;FUT	bi¹³	bi¹³
Ɂø²+tsúgɁ²	V;IRR;SG;1;FUT	Ɂø¹+tsogɁ²	Ɂø¹+tsog
ɁaiɁ²	V;IRR;SG;1;FUT	ɁaiɁ¹³	ɁaiɁ¹
hønɁ¹²	V;IRR;SG;1;FUT	hønɁ¹³	hønɁ¹³
tsøi¹²	V;IRR;SG;1;FUT	tsøi³	tsøi³³
Ɂuǿi²	V;IRR;SG;1;FUT	Ɂuai¹³	Ɂuøi¹
hnióɁ²	V;IRR;SG;1;FUT	hnioɁ²	hnioɁ³
tsenɁ¹²	V;IRR;SG;1;FUT	tsenɁ¹	tsenɁ¹³
guieng¹²	V;IRR;SG;1;FUT	guieng¹³	guieng¹
ɁǿnɁ²	V;IRR;SG;1;FUT	gøɁ¹³	ɁønɁ³
Ɂe¹²	V;IRR;SG;1;FUT	Ɂe¹³	Ɂe¹³n
nang¹²	V;IRR;SG;1;FUT	nang¹³	nang¹³
mē¹²	V;IRR;SG;1;FUT	mē¹³	mē¹³³
mi²+kiónɁ²	V;IRR;SG;1;FUT	mi¹+kionɁ³	mi¹+kion
kiagɁ¹²	V;IRR;SG;1;FUT	kiagɁ¹³	kiagɁ¹³
lio¹²	V;IRR;SG;1;FUT	lo¹³	loo¹³
sián²	V;IRR;SG;1;FUT	sian³	sian³
tian¹	V;IRR;SG;1;FUT	tian¹	tian¹
guiugɁ²	V;IRR;SG;1;FUT	guiugɁ¹	guiugɁ¹
ɁmēɁ¹²	V;IRR;SG;1;FUT	ɁmēɁ³	ɁmēɁ³³
mi²+hní¹	V;IRR;SG;1;FUT	mi¹+hni³	mi¹+hni
nié¹²	V;IRR;SG;1;FUT	na¹³	nie¹³
hngióɁ²	V;IRR;SG;1;FUT	hngioɁ³	hngioɁ³
tsēnɁ¹²	V;IRR;SG;1;FUT	tsenɁ¹²	tsēnɁ¹²
kang²	V;IRR;SG;1;FUT	kang¹³	kang¹
liúg²	V;IRR;SG;1;FUT	log³	liug³
ngǿi²	V;IRR;SG;1;FUT	ngai¹³	ngai¹
hḗɁ²	V;IRR;SG;1;FUT	hēɁ²	hēɁ²³
kø²+hinɁ¹²	V;IRR;SG;1;FUT	kø¹+hinɁ³	kø¹+hinɁ
guenɁ¹²	V;IRR;SG;1;FUT	guenɁ³	guenɁ³³
hénɁ¹²	V;IRR;SG;1;FUT	henɁ¹³	henɁ¹³
siúgɁ²	V;IRR;SG;1;FUT	siugɁ²	siugɁ²
hnáɁ¹²	V;IRR;SG;1;FUT	hnaɁ¹³	hnaɁ¹³
lánɁ²	V;IRR;SG;1;FUT	lanɁ¹³	lanɁ¹
Ɂnie¹²	V;IRR;SG;1;FUT	Ɂna³	Ɂnie¹³
ngie³	V;IRR;SG;1;FUT	ngie³	ngie³
ngieɁ¹³	V;IRR;SG;1;FUT	ngieɁ¹³	ngieɁ¹³
lióg¹²	V;IRR;SG;1;FUT	log¹³	loog¹³
mi²+gan¹	V;IRR;SG;1;FUT	mi¹+gan¹	mi¹+gan
kón²	V;IRR;SG;1;FUT	kon³	kon³³
ɁliágɁ¹²	V;IRR;SG;1;FUT	ɁliagɁ¹³	ɁliagɁ¹
ɁéɁ²	V;IRR;SG;1;FUT	ɁeɁ³	ɁeɁ¹³
Ɂnai¹²	V;IRR;SG;1;FUT	Ɂnai¹³	Ɂnai¹³
hngió²	V;IRR;SG;1;FUT	hngio¹³	hngio¹
chióg¹²	V;IRR;SG;1;FUT	chiog³	chiog³³
Ɂé²	V;IRR;SG;1;FUT	Ɂe²	Ɂe²³
mi²+hu¹	V;IRR;SG;1;FUT	mi¹+hu³	mi¹+hu³
kø¹²	V;IRR;SG;1;FUT	kø¹³	kø¹³³
Ɂia¹²	V;IRR;SG;1;FUT	Ɂia¹³	Ɂia¹³
u¹+lian¹	V;IRR;SG;1;FUT	u¹+lian¹	u¹+lian
Ɂian¹²	V;IRR;SG;1;FUT	Ɂian¹²	Ɂian¹²
bø²+lḗnɁ²	V;IRR;SG;1;FUT	bø¹+lēnɁ³	bø¹+lēnɁ
mi²+dsian¹²	V;IRR;SG;1;FUT	mi¹+dsian¹³	mi¹+dsian
kiang¹²	V;IRR;SG;1;FUT	kiang¹³	kiang¹³
chiúg²	V;IRR;SG;1;FUT	chiug¹³	chiug³
ɁánɁ²	V;IRR;SG;1;FUT	ɁanɁ¹³	ɁanɁ¹
ɁlanɁ¹²	V;IRR;SG;1;FUT	ɁlanɁ¹³	ɁlanɁ¹³
guu²+dsḗn¹³	V;IRR;SG;1;FUT	guu¹+dsēn¹³	guu¹+dsēn
guiánɁ¹²	V;IRR;SG;1;FUT	guianɁ¹³	guianɁ¹
hniá¹²	V;IRR;SG;1;FUT	hnia¹	hnia¹³
hlíɁ¹²	V;IRR;SG;1;FUT	hløɁ¹³	hliɁ¹³
Ɂí²	V;IRR;SG;1;FUT	Ɂu¹³	Ɂi¹³
séi²	V;IRR;SG;1;FUT	sei¹³	sei¹³
huen¹²	V;IRR;SG;1;FUT	huen¹³	huen¹³
ieg¹²	V;IRR;SG;1;FUT	øg¹³	øg¹³¹
rain¹²	V;IRR;SG;1;FUT	rain¹	rain¹³
hog¹²	V;IRR;SG;1;FUT	hog¹	hog¹³
chiúgɁ²	V;IRR;SG;1;FUT	chiugɁ³	chiugɁ¹
lan²	V;IRR;SG;1;FUT	len¹	lan¹¹
ɁénɁ¹²	V;IRR;SG;1;FUT	ɁenɁ¹³	ɁenɁ³³
kuan¹²	V;IRR;SG;1;FUT	kuan¹³	kuan¹³
guiég¹²	V;IRR;SG;1;FUT	guieg¹³	guieg¹³
Ɂéng²	V;IRR;SG;1;FUT	Ɂeng¹³	Ɂeng¹
tan¹³	V;IRR;SG;1;FUT	tan¹³	tan¹³
hnóɁ²	V;IRR;SG;1;FUT	hnoɁ¹³	hnoɁ¹
koɁ¹²	V;IRR;SG;1;FUT	koɁ¹³	koɁ¹³
gúɁ¹²	V;IRR;SG;1;FUT	guɁ¹³	guɁ¹³
kionɁ¹²	V;IRR;SG;1;FUT	kionɁ¹³	kionɁ¹³
Ɂai¹²	V;IRR;SG;1;FUT	Ɂai¹³	Ɂai¹³
téng²	V;IRR;SG;1;FUT	ton¹³	teng³
mi²+lei¹³	V;IRR;SG;1;FUT	mi¹+lei¹³	mi¹+lei¹
tógɁ¹²	V;IRR;SG;1;FUT	togɁ¹³	togɁ³³
mi²+liág¹	V;IRR;SG;1;FUT	mi¹+liag¹³	mi¹+liag
ɁlianɁ¹²	V;IRR;SG;1;FUT	ɁlianɁ¹³	ɁlianɁ¹
mi²+gag¹²	V;IRR;SG;1;FUT	mi¹+gag¹³	mi¹+gag¹
kieng¹²	V;IRR;SG;1;FUT	kieng¹³	kieng¹³
mi²+dsē¹²	V;IRR;SG;1;FUT	mi¹+dsē¹³	mi¹+dsē¹
hngiú²	V;IRR;SG;1;FUT	hngiu¹³	hngiu¹
kuø¹²	V;IRR;SG;1;FUT	kuø¹³	kuø¹³
hiúɁ²	V;IRR;SG;1;FUT	hioɁ³	hiuɁ³
dsén²	V;IRR;SG;1;FUT	dsen¹³	dsen¹
ɁiuɁ³ (ɁéɁ¹)	V;IRR;SG;1;FUT	ɁiuɁ³	ɁiuɁ³³²²Ɂ³
mi²+huanɁ¹²	V;IRR;SG;1;FUT	mi¹+huanɁ¹³	mi¹+huanɁ
ɁiúɁ¹²	V;IRR;SG;1;FUT	ɁiuɁ³	ɁiuɁ³²
hǿa¹²	V;IRR;SG;1;FUT	høa¹³	høa¹³
tan¹²	V;IRR;SG;1;FUT	tan¹	tan¹³
ko¹²	V;IRR;SG;1;FUT	ko¹³	ko¹³²
ti²+dsøa¹²	V;IRR;SG;1;FUT	ti¹+dsøa²	ti¹+dsøa
tson¹²	V;IRR;SG;1;FUT	tson¹	tson¹¹
Ɂøin¹²	V;IRR;SG;1;FUT	Ɂøin³	Ɂøin¹³
dsióɁ¹² hǿg³	V;IRR;SG;1;FUT	dsioɁ¹³	dsioɁ¹³²³¹
chi²+láɁ²	V;IRR;SG;1;FUT	chi¹+laɁ¹³	chi¹+laɁ
hai¹²	V;IRR;SG;1;FUT	hai¹³	hai¹³
tanɁ¹²	V;IRR;SG;1;FUT	tanɁ³	tanɁ¹³
ɁnangɁ²	V;IRR;SG;1;FUT	ɁnangɁ¹³	ɁnangɁ¹
hlian¹²	V;IRR;SG;1;FUT	hlian¹	hlian¹³
tion¹²	V;IRR;SG;1;FUT	ton¹³	tion³¹
mi²+hngiáng¹	V;IRR;SG;1;FUT	mi¹+hngiang¹³	mi¹+hngian
Ɂlí²	V;IRR;SG;1;FUT	Ɂli¹³	Ɂli¹³
húg²	V;IRR;SG;1;FUT	hug²	hug¹³
ɁlogɁ²	V;IRR;SG;1;FUT	ɁlogɁ¹	ɁlogɁ¹
mi²+ɁmaɁ¹³	V;IRR;SG;1;FUT	mi¹+ɁmaɁ¹³	mi¹+ɁmaɁ
siág¹²	V;IRR;SG;1;FUT	siog³	siag³³
dsiog¹²	V;IRR;SG;1;FUT	dsiog³	dsiog³¹
mi²+hog¹²	V;IRR;SG;1;FUT	mi¹+hog³	mi¹+hog³
chiínɁ²	V;IRR;SG;1;FUT	hmaɁ¹³	hmaɁ¹³¹
dsúgɁ¹²	V;IRR;SG;1;FUT	dsugɁ¹	dsugɁ³³
héi²	V;IRR;SG;1;FUT	hi³	hei¹³
mi²+dsiúg²	V;IRR;SG;1;FUT	mi¹+dsiug³	mi¹+dsiu
hnia¹²	V;IRR;SG;1;FUT	hnia¹	hnia¹³
hnḗ¹²	V;IRR;SG;1;FUT	hnē¹	hnē¹³
mi²+tián² (dsǿa¹²)	V;IRR;SG;1;FUT	mi¹+tian³	mi¹+tian³³³(((
u²+nio¹³	V;IRR;SG;1;FUT	u¹+nio¹²	u¹+nio¹
mi²+Ɂog¹³	V;IRR;SG;1;FUT	mi¹+Ɂog³	mi¹+Ɂog³
lēɁ²	V;IRR;SG;1;FUT	lēɁ³	lēɁ³³
iéiɁ¹²	V;IRR;SG;1;FUT	ieiɁ¹³	ieiɁ¹³
bá²	V;IRR;SG;1;FUT	ba³	ba³¹
bḗn²	V;IRR;SG;1;FUT	bēn¹³	bēn¹³
nei¹²	V;IRR;SG;1;FUT	nei³	nei³¹
hínɁ¹²	V;IRR;SG;1;FUT	hinɁ³	hinɁ³³
Ɂēn¹²	V;IRR;SG;1;FUT	Ɂēn³	Ɂēn¹³
gḗɁ²	V;IRR;SG;1;FUT	gēɁ²	gēɁ²³
mi²+ténɁ²	V;IRR;SG;1;FUT	mi¹+tenɁ³	mi¹+tenɁ
háng¹²	V;IRR;SG;1;FUT	hang³	hang¹³
kḗn²	V;IRR;SG;1;FUT	kien²	kēn²²
ton²	V;IRR;SG;1;FUT	ton²	ton¹³
u²+Ɂai¹²	V;IRR;SG;1;FUT	u¹+Ɂai¹	u¹+Ɂai¹
chi²+ngiú²	V;IRR;SG;1;FUT	chi¹+ngiu³	chi¹+ngi
kø²+káng¹²	V;IPFV;PL;1;PST	mi³-kø²+kang¹²	mi³-kø²+kang¹
guiágɁ¹²	V;IPFV;PL;1;PST	mi³-guiagɁ¹²	mi³-guiagɁ¹
bø²+hmé²	V;IPFV;PL;1;PST	mi³-bø²+hme²	mi³-bø²+hme
ɁnóɁ¹² dsí²	V;IPFV;PL;1;PST	mi³-ɁnoɁ¹²	mi³-ɁnoɁ¹²²³²³
Ɂuø¹²	V;IPFV;PL;1;PST	mi³-Ɂuø³	mi³-Ɂuø¹²
guión²	V;IPFV;PL;1;PST	mi³-guion³	mi³-guion³
lǿɁ²	V;IPFV;PL;1;PST	mi³-løɁ²	mi³-løɁ²
héinɁ¹²	V;IPFV;PL;1;PST	mi³-heinɁ³	mi³-heinɁ¹²
Ɂien¹²	V;IPFV;PL;1;PST	mi³-Ɂien¹²	mi³-Ɂien¹²
mi²+kionɁ¹	V;IPFV;PL;1;PST	mi³-mi²+kionɁ¹³	mi³-mi²+kionɁ
hénɁ²	V;IPFV;PL;1;PST	mi³-henɁ³	mi³-henɁ²
hǿɁ¹²	V;IPFV;PL;1;PST	mi³-høɁ¹²	mi³-høɁ¹²
chi²+dsán²	V;IPFV;PL;1;PST	mi³-chi²+dsan¹²	mi³-chi²+dsan
guiúg²	V;IPFV;PL;1;PST	mi³-guiug¹²	mi³-guiug¹
niá¹²	V;IPFV;PL;1;PST	mi³-nia¹²	mi³-nia¹²
tangɁ²	V;IPFV;PL;1;PST	mi³-tiangɁ²	mi³-tangɁ³
Ɂan¹²	V;IPFV;PL;1;PST	mi³-Ɂan¹²	mi³-Ɂan¹²
dsian¹²	V;IPFV;PL;1;PST	mi³-dsian¹²	mi³-dsian¹²
hmóngɁ¹²	V;IPFV;PL;1;PST	mi³-hmongɁ²	mi³-hmongɁ²
chi²+dsí²	V;IPFV;PL;1;PST	mi³-chi²+dsi³	mi³-chi²+dsi
tánɁ¹²	V;IPFV;PL;1;PST	mi³-tanɁ¹²	mi³-tanɁ¹²
kuøin¹²	V;IPFV;PL;1;PST	mi³-kuøin¹²	mi³-kuøin¹²
tsø²+nióɁ¹²	V;IPFV;PL;1;PST	mi³-tsø²+nioɁ¹	mi³-tsø²+nioɁ¹
ɁuáiɁ¹²	V;IPFV;PL;1;PST	mi³-ɁuaiɁ¹²	mi³-ɁuaiɁ¹²
mi²+hénɁ²	V;IPFV;PL;1;PST	mi³-mi²+henɁ³	mi³-mi²+henɁ
hánɁ¹²	V;IPFV;PL;1;PST	mi³-hanɁ¹²	mi³-hanɁ¹²
mi²+kiíngɁ²	V;IPFV;PL;1;PST	mi³-mi²+kiingɁ³	mi³-mi²+kiingɁ
ɁúgɁ²	V;IPFV;PL;1;PST	mi³-ɁogɁ³	mi³-ɁugɁ³
tieɁ¹²	V;IPFV;PL;1;PST	mi³-tieɁ²	mi³-tieɁ¹²
hiúg²	V;IPFV;PL;1;PST	mi³-hiug³	mi³-hiug²
chio¹²	V;IPFV;PL;1;PST	mi³-chieg²	mi³-chiog²
tian¹²	V;IPFV;PL;1;PST	mi³-tian¹²	mi³-tian¹²
mi²+hmḗ²	V;IPFV;PL;1;PST	mi³-mi²+hmē³	mi³-mi²+hmē
ngē¹²	V;IPFV;PL;1;PST	mi³-ngē¹³	mi³-ngē¹²
lanɁ¹²	V;IPFV;PL;1;PST	mi³-lanɁ¹²	mi³-lanɁ¹²
ngái¹²	V;IPFV;PL;1;PST	mi³-ngai³	mi³-ngai³²
tión²	V;IPFV;PL;1;PST	mi³-tion²	mi³-tion¹
tsø²+kuenɁ¹²	V;IPFV;PL;1;PST	mi³-tsø²+kuenɁ¹²	mi³-tsø²+kuenɁ
Ɂøa¹²	V;IPFV;PL;1;PST	mi³-Ɂi²	mi³-Ɂøa¹²
hngiáɁ²	V;IPFV;PL;1;PST	mi³-hngiaɁ¹²	mi³-hngiaɁ¹
ngøa¹²	V;IPFV;PL;1;PST	mi³-ngøa²	mi³-ngøa³³
ɁlianɁ²	V;IPFV;PL;1;PST	mi³-ɁlianɁ²	mi³-ɁlianɁ³
hngióɁ¹²	V;IPFV;PL;1;PST	mi³-hngioɁ¹³	mi³-hngioɁ¹
se¹²	V;IPFV;PL;1;PST	mi³-se¹²	mi³-se¹²
tsǿɁ¹²	V;IPFV;PL;1;PST	mi³-tsøɁ¹²	mi³-tsøɁ¹²
ta¹²	V;IPFV;PL;1;PST	mi³-ta²	mi³-ta¹²
rónɁ¹²	V;IPFV;PL;1;PST	mi³-ronɁ¹²	mi³-ronɁ¹²
ha²+Ɂan³	V;IPFV;PL;1;PST	mi³-ha²+Ɂan³	mi³-ha²+Ɂan
kúgɁ¹²	V;IPFV;PL;1;PST	mi³-kugɁ¹²	mi³-kugɁ¹²
nioɁ²	V;IPFV;PL;1;PST	mi³-nioɁ²	mi³-nioɁ²
huúɁ¹²	V;IPFV;PL;1;PST	mi³-huuɁ³	mi³-huuɁ¹³
kágɁ¹²	V;IPFV;PL;1;PST	mi³-kagɁ³	mi³-kagɁ¹²
guái²	V;IPFV;PL;1;PST	mi³-guai¹²	mi³-guai¹
hḗnɁ²	V;IPFV;PL;1;PST	mi³-hēnɁ¹³	mi³-hēnɁ¹
mi²+hnia¹²	V;IPFV;PL;1;PST	mi³-mi²+hnia¹³	mi³-mi²+hnia¹
hian¹²	V;IPFV;PL;1;PST	mi³-hian¹²	mi³-hian¹²
ku² hmo¹²	V;IPFV;PL;1;PST	mi³-ku²	mi³-ku²an¹²²
kión²	V;IPFV;PL;1;PST	mi³-kion³	mi³-kion¹
téiɁ¹²	V;IPFV;PL;1;PST	mi³-teiɁ²	mi³-teiɁ²²
tsog¹²	V;IPFV;PL;1;PST	mi³-tsog¹³	mi³-tsog²²
hnḗɁ²	V;IPFV;PL;1;PST	mi³-hnēɁ³	mi³-hnēɁ³
ɁóɁ²	V;IPFV;PL;1;PST	mi³-ɁoɁ¹²	mi³-ɁoɁ³
ngē²	V;IPFV;PL;1;PST	mi³-ngē²	mi³-ngē²
mi²+dsēn¹²	V;IPFV;PL;1;PST	mi³-mi²+dsēn¹³	mi³-mi²+dsēn¹
mi²+ɁḗɁ²	V;IPFV;PL;1;PST	mi³-mi²+ɁēɁ³	mi³-mi²+ɁēɁ
tø²+ɁénɁ¹²	V;IPFV;PL;1;PST	mi³-tø²+ɁenɁ¹³	mi³-tø²+ɁenɁ¹
rón²	V;IPFV;PL;1;PST	mi³-ron³	mi³-ron³
hnǿ²	V;IPFV;PL;1;PST	mi³-hnø¹²	mi³-hnø¹
hnaiɁ¹²	V;IPFV;PL;1;PST	mi³-hnaiɁ³	mi³-hnaiɁ¹²
tai²	V;IPFV;PL;1;PST	mi³-tei³	mi³-tai³
mi²+tan¹³	V;IPFV;PL;1;PST	mi³-mi²+tan¹³	mi³-mi²+tan¹
ɁuǿɁ¹²	V;IPFV;PL;1;PST	mi³-ɁuøɁ¹³	mi³-ɁuøɁ¹²
kán²	V;IPFV;PL;1;PST	mi³-kian¹²	mi³-kan²
háinɁ¹²	V;IPFV;PL;1;PST	mi³-hainɁ²	mi³-hainɁ¹²
dsø²+huen¹³	V;IPFV;PL;1;PST	mi³-dsø²+huen¹³	mi³-dsø²+huen¹
lag²	V;IPFV;PL;1;PST	mi³-lag²	mi³-lag²
kiúgɁ²	V;IPFV;PL;1;PST	mi³-kiugɁ³	mi³-kiugɁ³
huú²	V;IPFV;PL;1;PST	mi³-huø¹²	mi³-huu²
mi²+Ɂnio¹	V;IPFV;PL;1;PST	mi³-mi²+Ɂnio¹	mi³-mi²+Ɂnio
bán²	V;IPFV;PL;1;PST	mi³-ban¹²	mi³-ban¹
mi²+tég²	V;IPFV;PL;1;PST	mi³-mi²+teg³	mi³-mi²+teg
kiuɁ¹²	V;IPFV;PL;1;PST	mi³-kiuɁ²	mi³-kiuɁ¹²
mi²+gug¹	V;IPFV;PL;1;PST	mi³-mi²+gug¹	mi³-mi²+gug
len¹²	V;IPFV;PL;1;PST	mi³-len¹²	mi³-len¹²
gog²	V;IPFV;PL;1;PST	mi³-gog²	mi³-gog²
niá²	V;IPFV;PL;1;PST	mi³-nia²	mi³-nia²
Ɂno¹²	V;IPFV;PL;1;PST	mi³-Ɂnio¹²	mi³-Ɂno¹²
mi²+kien¹²	V;IPFV;PL;1;PST	mi³-mi²+kien¹³	mi³-mi²+kien¹
chióɁ¹²	V;IPFV;PL;1;PST	mi³-chioɁ³	mi³-chioɁ³³
ngiéɁ¹²	V;IPFV;PL;1;PST	mi³-ngieɁ³	mi³-ngieɁ³²
siúg²	V;IPFV;PL;1;PST	mi³-siug³	mi³-siug²
teng¹²	V;IPFV;PL;1;PST	mi³-teng²	mi³-teng¹²
guiónɁ²	V;IPFV;PL;1;PST	mi³-guionɁ³	mi³-guionɁ³
hanɁ¹² dsǿa¹²	V;IPFV;PL;1;PST	mi³-hanɁ¹²	mi³-hanɁ¹²²³³³²
ngié²	V;IPFV;PL;1;PST	mi³-ngie²	mi³-ngie²
tsogɁ² hmøi²	V;IPFV;PL;1;PST	mi³-tsogɁ²	mi³-tsogɁ²³³²³
ɁnáiɁ¹²	V;IPFV;PL;1;PST	mi³-ɁnaiɁ²	mi³-ɁnaiɁ¹²
hnio³	V;IPFV;PL;1;PST	mi³-hnio³	mi³-hnio³
Ɂngio¹²	V;IPFV;PL;1;PST	mi³-Ɂngio¹²	mi³-Ɂngio¹²
guǿn¹²	V;IPFV;PL;1;PST	mi³-guøn¹²	mi³-guøn¹²
tán¹²	V;IPFV;PL;1;PST	mi³-tig¹²	mi³-tan¹²
Ɂio¹²	V;IPFV;PL;1;PST	mi³-Ɂieg²	mi³-Ɂio¹²
hen¹²	V;IPFV;PL;1;PST	mi³-hen¹²	mi³-hen¹²
hián²	V;IPFV;PL;1;PST	mi³-hian²	mi³-hian³
kii²+túg²	V;IPFV;PL;1;PST	mi³-kii²+tog³	mi³-kii²+tog
kii²+tág¹²	V;IPFV;PL;1;PST	mi³-kii²+tag²	mi³-kii²+tag²
Ɂán²	V;IPFV;PL;1;PST	mi³-Ɂan¹²	mi³-Ɂan¹
køn¹²	V;IPFV;PL;1;PST	mi³-køn²	mi³-køn²¹
Ɂiog²	V;IPFV;PL;1;PST	mi³-Ɂiog²	mi³-Ɂiog²
tsog²	V;IPFV;PL;1;PST	mi³-tsog²	mi³-tsog²
mi²+tsḗn¹	V;IPFV;PL;1;PST	mi³-mi²+tsēn¹³	mi³-mi²+tsēn
kugɁ¹²	V;IPFV;PL;1;PST	mi³-kugɁ¹³	mi³-kugɁ¹²
tsǿaɁ¹²	V;IPFV;PL;1;PST	mi³-tsenɁ¹²	mi³-tsøaɁ¹²
hne¹²	V;IPFV;PL;1;PST	mi³-hngiu²	mi³-hne¹²
ɁioɁ¹²	V;IPFV;PL;1;PST	mi³-ɁioɁ¹²	mi³-ɁioɁ¹²
tsǿng²	V;IPFV;PL;1;PST	mi³-tsøng¹²	mi³-tsøng¹
hág¹²	V;IPFV;PL;1;PST	mi³-hag¹³	mi³-hag¹³
hmóɁ¹²	V;IPFV;PL;1;PST	mi³-hmoɁ³	mi³-hmoɁ³²
hngie¹²	V;IPFV;PL;1;PST	mi³-hngie³	mi³-hngie³²
nēɁ¹²	V;IPFV;PL;1;PST	mi³-nēɁ¹²	mi³-nēɁ¹²
húɁ²	V;IPFV;PL;1;PST	mi³-huɁ²	mi³-huɁ²
Ɂnia¹²	V;IPFV;PL;1;PST	mi³-Ɂnia¹³	mi³-Ɂnia¹³
héin¹²	V;IPFV;PL;1;PST	mi³-hein³	mi³-hein³³
dsúgɁ²	V;IPFV;PL;1;PST	mi³-dsugɁ³	mi³-dsugɁ³
mi²+tan¹²	V;IPFV;PL;1;PST	mi³-mi²+tan³	mi³-mi²+tan³
ɁēnɁ¹²	V;IPFV;PL;1;PST	mi³-ɁenɁ²	mi³-ɁēnɁ²²
kióɁ¹²	V;IPFV;PL;1;PST	mi³-kioɁ³	mi³-kioɁ¹²
Ɂlúg²	V;IPFV;PL;1;PST	mi³-Ɂlug²	mi³-Ɂlug²
møa¹²	V;IPFV;PL;1;PST	mi³-møa²	mi³-møa²¹
gǿaɁ¹²	V;IPFV;PL;1;PST	mi³-kie¹²	mi³-gie¹²²
guen²	V;IPFV;PL;1;PST	mi³-guøi²	mi³-guen²
tug	V;IPFV;PL;1;PST	mi³-tug¹²	mi³-tug¹
hngēɁ¹²	V;IPFV;PL;1;PST	mi³-hngēɁ²	mi³-hngēɁ²²
hmǿɁ¹²	V;IPFV;PL;1;PST	mi³-hmøɁ²	mi³-hmøɁ¹²
dsie¹²	V;IPFV;PL;1;PST	mi³-dsie²	mi³-dsie²²
tsénɁ²	V;IPFV;PL;1;PST	mi³-tsenɁ³	mi³-tsenɁ³
chiunɁ¹²	V;IPFV;PL;1;PST	mi³-chiunɁ³	mi³-chiunɁ³
Ɂméi¹²	V;IPFV;PL;1;PST	mi³-Ɂmei³	mi³-Ɂmei¹²
tióɁ¹²	V;IPFV;PL;1;PST	mi³-tioɁ¹²	mi³-tioɁ¹²
tø²+húg³	V;IPFV;PL;1;PST	mi³-tø²+hug³	mi³-tø²+hug
kug²	V;IPFV;PL;1;PST	mi³-kug²	mi³-kug²
tsēn¹²	V;IPFV;PL;1;PST	mi³-tsig²	mi³-tsēn¹²
chiogɁ¹²	V;IPFV;PL;1;PST	mi³-chiogɁ¹²	mi³-chiogɁ¹
chi²+lánɁ²	V;IPFV;PL;1;PST	mi³-chi²+lanɁ¹²	mi³-chi²+lanɁ
mi²+kuuɁ¹²	V;IPFV;PL;1;PST	mi³-mi²+kuuɁ¹³	mi³-mi²+kuuɁ¹
tø²+gugɁ¹²	V;IPFV;PL;1;PST	mi³-tø²+gugɁ¹²	mi³-tø²+gugɁ¹
mi²+hlíɁ²	V;IPFV;PL;1;PST	mi³-mi²+hliɁ³	mi³-mi²+hliɁ
mi²+níɁ¹	V;IPFV;PL;1;PST	mi³-mi²+niɁ³	mi³-mi²+niɁ
køɁ³ (hmai³)	V;IPFV;PL;1;PST	mi³-køɁ³	mi³-køɁ³²²Ɂ²¹²
niuɁ³	V;IPFV;PL;1;PST	mi³-niuɁ³	mi³-niuɁ³
hngiángɁ¹²	V;IPFV;PL;1;PST	mi³-hngiangɁ³	mi³-hngiangɁ³
tsø²+han¹²	V;IPFV;PL;1;PST	mi³-tsø²+han¹²	mi³-tsø²+han¹
kién¹²	V;IPFV;PL;1;PST	mi³-kien¹³	mi³-kien¹³
hḗn²	V;IPFV;PL;1;PST	mi³-hēn¹²	mi³-hēn¹
ngai¹²	V;IPFV;PL;1;PST	mi³-ngai³	mi³-ngai³²
mi²+hngió¹	V;IPFV;PL;1;PST	mi³-mi²+hngio¹³	mi³-mi²+hngio
chión²	V;IPFV;PL;1;PST	mi³-chion³	mi³-chion³
guianɁ¹²	V;IPFV;PL;1;PST	mi³-guianɁ²	mi³-guianɁ²
dsiég¹²	V;IPFV;PL;1;PST	mi³-dsieg¹²	mi³-dsieg¹²
tǿɁ²	V;IPFV;PL;1;PST	mi³-te¹²	mi³-tøɁ²
hnáɁ²	V;IPFV;PL;1;PST	mi³-hnaɁ³	mi³-hnaɁ³
ngøɁ¹²	V;IPFV;PL;1;PST	mi³-ngøɁ³	mi³-ngøɁ³²
huúɁ²	V;IPFV;PL;1;PST	mi³-huuɁ²	mi³-huuɁ³
mi²+gan¹²	V;IPFV;PL;1;PST	mi³-mi²+gan¹³	mi³-mi²+gan¹
káiɁ¹²	V;IPFV;PL;1;PST	mi³-kieiɁ¹²	mi³-kaiɁ¹²
chi²+hné¹	V;IPFV;PL;1;PST	mi³-chi²+hne³	mi³-chi²+hne
guen¹²	V;IPFV;PL;1;PST	mi³-guen³	mi³-guen¹²
tónɁ² (huu¹²)	V;IPFV;PL;1;PST	mi³-tiunɁ¹²	mi³-tiunɁ¹²³²³³
tanɁ²	V;IPFV;PL;1;PST	mi³-tanɁ²	mi³-tanɁ²
hogɁ¹²	V;IPFV;PL;1;PST	mi³-hogɁ¹²	mi³-hogɁ¹²
Ɂuan¹²	V;IPFV;PL;1;PST	mi³-Ɂuan¹³	mi³-Ɂuan¹³
li²	V;IPFV;PL;1;PST	mi³-li²	mi³-li¹²
Ɂúg²	V;IPFV;PL;1;PST	mi³-Ɂug¹²	mi³-Ɂug²
kēnɁ¹²	V;IPFV;PL;1;PST	mi³-kienɁ¹²	mi³-kēnɁɁ²
dsióɁ¹²	V;IPFV;PL;1;PST	mi³-dsioɁ³	mi³-dsioɁ³²
tsiɁ¹²	V;IPFV;PL;1;PST	mi³-tsiɁ²	mi³-tsiɁ²²
tsánɁ²	V;IPFV;PL;1;PST	mi³-chianɁ¹²	mi³-tsanɁ³
bén²	V;IPFV;PL;1;PST	mi³-ben¹²	mi³-ben¹
hlái²	V;IPFV;PL;1;PST	mi³-hlai¹²	mi³-hlai³
héɁ²	V;IPFV;PL;1;PST	mi³-heɁ³	mi³-heɁ³
ɁnióɁ¹²	V;IPFV;PL;1;PST	mi³-ɁnioɁ¹²	mi³-ɁnioɁ³²
ngiú²	V;IPFV;PL;1;PST	mi³-ngiu²	mi³-ngiu²
tag¹²	V;IPFV;PL;1;PST	mi³-teg²	mi³-tag¹³
ɁiánɁ²	V;IPFV;PL;1;PST	mi³-ɁianɁ¹²	mi³-ɁianɁ³
mi²+Ɂai¹	V;IPFV;PL;1;PST	mi³-mi²+Ɂai¹	mi³-mi²+Ɂai
kiog¹²	V;IPFV;PL;1;PST	mi³-kiog²	mi³-kiog¹²
chi²+dsén²	V;IPFV;PL;1;PST	mi³-chi²+dsen¹³	mi³-chi²+dsen
hlán²	V;IPFV;PL;1;PST	mi³-hlan³	mi³-hlan³
u¹+lén²	V;IPFV;PL;1;PST	mi³-u²+len¹³	mi³-u²+len¹
dsan²	V;IPFV;PL;1;PST	mi³-dsan²	mi³-dsan²
ɁónɁ²	V;IPFV;PL;1;PST	mi³-ɁonɁ³	mi³-ɁonɁ²
hmáɁ² (ta³)	V;IPFV;PL;1;PST	mi³-hmaɁ¹³	mi³-hmaɁ¹³²¹³²
dsán²	V;IPFV;PL;1;PST	mi³-dsan¹²	mi³-dsan¹
tiun¹²	V;IPFV;PL;1;PST	mi³-teng¹²	mi³-tiun¹²
lø²+liúɁ²	V;IPFV;PL;1;PST	mi³-lø²+liuɁ¹²	mi³-lø²+liuɁ
dsǿɁ²	V;IPFV;PL;1;PST	mi³-dsøɁ¹²	mi³-dsøɁ¹
ha¹²	V;IPFV;PL;1;PST	mi³-ha¹³	mi³-ha¹²
guian¹²	V;IPFV;PL;1;PST	mi³-guian¹³	mi³-guian¹²
ti²+li¹	V;IPFV;PL;1;PST	mi³-ti²+li³	mi³-ti²+li³
Ɂien²	V;IPFV;PL;1;PST	mi³-Ɂien²	mi³-Ɂien²
guiúnɁ¹²	V;IPFV;PL;1;PST	mi³-guiunɁ¹²	mi³-guiunɁ¹
hliánɁ²	V;IPFV;PL;1;PST	mi³-hlianɁ¹³	mi³-hlianɁ³
mi²+gǿg¹	V;IPFV;PL;1;PST	mi³-mi²+gøg¹	mi³-mi²+gøg
hnó²	V;IPFV;PL;1;PST	mi³-hno³	mi³-hno³
ti²+dsiog¹	V;IPFV;PL;1;PST	mi³-ti²+dsiog³	mi³-ti²+dsiog
Ɂngieng¹²	V;IPFV;PL;1;PST	mi³-Ɂngieng²	mi³-Ɂngieng²
hné¹²	V;IPFV;PL;1;PST	mi³-hne³	mi³-hne¹³
chiog¹²	V;IPFV;PL;1;PST	mi³-chiog²	mi³-chiog¹²
mái¹²	V;IPFV;PL;1;PST	mi³-mai²	mi³-mai²²
mi²+rø¹²	V;IPFV;PL;1;PST	mi³-mi²+rø³	mi³-mi²+rø³
tiú²	V;IPFV;PL;1;PST	mi³-tiu¹²	mi³-tiu¹
dsogɁ¹²	V;IPFV;PL;1;PST	mi³-dsogɁ¹²	mi³-dsogɁ¹²
hiugɁ¹²	V;IPFV;PL;1;PST	mi³-hiugɁ³	mi³-hiugɁ¹²
kií¹²	V;IPFV;PL;1;PST	mi³-kii²	mi³-kii²¹
kian¹²	V;IPFV;PL;1;PST	mi³-kian³	mi³-kian¹²
mi²+hínɁ²	V;IPFV;PL;1;PST	mi³-mi²+hinɁ³	mi³-mi²+hinɁ
Ɂngiéng¹²	V;IPFV;PL;1;PST	mi³-Ɂngieng²	mi³-Ɂngieng²
tián²	V;IPFV;PL;1;PST	mi³-tian¹²	mi³-tian¹
ɁnáɁ¹²	V;IPFV;PL;1;PST	mi³-ɁniaɁ¹²	mi³-ɁnaɁ¹²
tso¹²	V;IPFV;PL;1;PST	mi³-chieg²	mi³-tso¹²
siég²	V;IPFV;PL;1;PST	mi³-sieg¹²	mi³-sieg¹
sianɁ¹²	V;IPFV;PL;1;PST	mi³-sianɁ¹³	mi³-sianɁ¹²
nió²	V;IPFV;PL;1;PST	mi³-nio¹²	mi³-nio¹
tsén²	V;IPFV;PL;1;PST	mi³-tsen³	mi³-tsen²
búɁ¹²	V;IPFV;PL;1;PST	mi³-buɁ¹²	mi³-buɁ¹²
mi²+guionɁ¹	V;IPFV;PL;1;PST	mi³-mi²+guionɁ³	mi³-mi²+guionɁ
kúgɁ²	V;IPFV;PL;1;PST	mi³-kogɁ³	mi³-kugɁ³
ɁngióɁ¹²	V;IPFV;PL;1;PST	mi³-hiɁ²	mi³-ɁngioɁ¹
Ɂma¹²	V;IPFV;PL;1;PST	mi³-Ɂma¹²	mi³-Ɂma¹²
chiágɁ¹²	V;IPFV;PL;1;PST	mi³-chiagɁ²	mi³-chiagɁ¹
tø²+kanɁ¹³	V;IPFV;PL;1;PST	mi³-tø²+kanɁ¹³	mi³-tø²+kanɁ¹
ngáɁ¹²	V;IPFV;PL;1;PST	mi³-ngaɁ²	mi³-ngaɁ³²
mi²+Ɂliúg²	V;IPFV;PL;1;PST	mi³-mi²+Ɂliug³	mi³-mi²+Ɂliug
tanɁ¹² huu¹²	V;IPFV;PL;1;PST	mi³-tianɁ²	mi³-tianɁ²¹²¹²
Ɂug¹²	V;IPFV;PL;1;PST	mi³-Ɂug¹³	mi³-Ɂug¹³
hái¹²	V;IPFV;PL;1;PST	mi³-hai²	mi³-hai¹²
hén²	V;IPFV;PL;1;PST	mi³-hen²	mi³-hen¹
mi²+Ɂan¹²	V;IPFV;PL;1;PST	mi³-mi²+Ɂan¹³	mi³-mi²+Ɂan¹
dsēn¹²	V;IPFV;PL;1;PST	mi³-dsēn¹³	mi³-dsēn¹²
hngieng¹²	V;IPFV;PL;1;PST	mi³-hngieng²	mi³-hngieng²
tsai¹²	V;IPFV;PL;1;PST	mi³-tsai¹²	mi³-tsai¹²
pø²+hánɁ²	V;IPFV;PL;1;PST	mi³-pø²+hanɁ¹²	mi³-pø²+hanɁ
lá¹²	V;IPFV;PL;1;PST	mi³-lie¹²	mi³-la²²
bí²	V;IPFV;PL;1;PST	mi³-bi¹²	mi³-bu¹²
Ɂø²+tsúgɁ²	V;IPFV;PL;1;PST	mi³-Ɂø²+tsogɁ²	mi³-Ɂø²+tsogɁ
ɁaiɁ²	V;IPFV;PL;1;PST	mi³-ɁeiɁ²	mi³-ɁaiɁ²
Ɂéi¹²	V;IPFV;PL;1;PST	mi³-Ɂei¹³	mi³-Ɂei¹²
mi²+kiín¹	V;IPFV;PL;1;PST	mi³-mi²+kiin³	mi³-mi²+kiin
hønɁ¹²	V;IPFV;PL;1;PST	mi³-hinɁ¹²	mi³-hønɁ¹²
kuǿɁ¹²	V;IPFV;PL;1;PST	mi³-kuøɁ¹²	mi³-kuøɁ¹²
Ɂuǿi²	V;IPFV;PL;1;PST	mi³-Ɂuai¹²	mi³-Ɂuøi¹
tsenɁ¹²	V;IPFV;PL;1;PST	mi³-tsenɁ¹²	mi³-tsenɁ¹²
ɁǿnɁ²	V;IPFV;PL;1;PST	mi³-ɁniuɁ²	mi³-ɁønɁ²
Ɂe¹²	V;IPFV;PL;1;PST	mi³-Ɂe²	mi³-Ɂe²³
nang¹²	V;IPFV;PL;1;PST	mi³-neng²	mi³-nang²²
ngó¹²	V;IPFV;PL;1;PST	mi³-ngo²	mi³-ngo¹³
mē¹²	V;IPFV;PL;1;PST	mi³-mē¹²	mi³-mē¹²
mi²+kiónɁ²	V;IPFV;PL;1;PST	mi³-mi²+kionɁ³	mi³-mi²+kionɁ
kiagɁ¹²	V;IPFV;PL;1;PST	mi³-kiagɁ²	mi³-kiagɁ¹²
lio¹²	V;IPFV;PL;1;PST	mi³-leg²	mi³-lio²²
sián²	V;IPFV;PL;1;PST	mi³-sian³	mi³-sian³
mi²+kán¹²	V;IPFV;PL;1;PST	mi³-mi²+kan³	mi³-mi²+kan³
guiugɁ²	V;IPFV;PL;1;PST	mi³-guiugɁ²	mi³-guiugɁ²
ɁmēɁ¹²	V;IPFV;PL;1;PST	mi³-ɁmēɁ¹²	mi³-ɁmēɁ¹²
nié¹²	V;IPFV;PL;1;PST	mi³-nie²	mi³-nie¹²
ɁenɁ¹²	V;IPFV;PL;1;PST	mi³-ɁenɁ¹³	mi³-ɁenɁ¹²
tsēnɁ¹²	V;IPFV;PL;1;PST	mi³-tsēnɁ¹²	mi³-tsēnɁ¹²
mḗɁ²	V;IPFV;PL;1;PST	mi³-mēɁ³	mi³-mēɁ²
kang²	V;IPFV;PL;1;PST	mi³-kieng²	mi³-kang²
ngǿi²	V;IPFV;PL;1;PST	mi³-ngai¹²	mi³-ngøi¹
hḗɁ²	V;IPFV;PL;1;PST	mi³-hēɁ²	mi³-hēɁ²
guenɁ¹²	V;IPFV;PL;1;PST	mi³-guenɁ¹²	mi³-guenɁ¹²
siúgɁ²	V;IPFV;PL;1;PST	mi³-siugɁ²	mi³-siugɁ²
Ɂnie¹²	V;IPFV;PL;1;PST	mi³-Ɂnie³	mi³-Ɂnie²²
ngie³	V;IPFV;PL;1;PST	mi³-ngie³	mi³-ngie³
ngieɁ¹³	V;IPFV;PL;1;PST	mi³-ngieɁ¹³	mi³-ngieɁ¹³
lióg¹²	V;IPFV;PL;1;PST	mi³-liog¹²	mi³-liog¹²
mi²+gan¹	V;IPFV;PL;1;PST	mi³-mi²+gan¹	mi³-mi²+gan
kón²	V;IPFV;PL;1;PST	mi³-kon³	mi³-kon²
Ɂian²	V;IPFV;PL;1;PST	mi³-Ɂian²	mi³-Ɂian²
ɁliágɁ¹²	V;IPFV;PL;1;PST	mi³-ɁliagɁ²	mi³-ɁliagɁ¹
Ɂnai¹²	V;IPFV;PL;1;PST	mi³-Ɂnøi²	mi³-Ɂnai¹²
hngió²	V;IPFV;PL;1;PST	mi³-hngio¹²	mi³-hngio¹
Ɂme¹²	V;IPFV;PL;1;PST	mi³-Ɂme²	mi³-Ɂme²²
Ɂé²	V;IPFV;PL;1;PST	mi³-Ɂe¹²	mi³-Ɂe¹²
Ɂmóng¹²	V;IPFV;PL;1;PST	mi³-Ɂmong¹²	mi³-Ɂmong¹²
mi²+hu¹	V;IPFV;PL;1;PST	mi³-mi²+hu³	mi³-mi²+hu³
kø¹²	V;IPFV;PL;1;PST	mi³-kø²	mi³-kø²²
Ɂia¹²	V;IPFV;PL;1;PST	mi³-Ɂia¹²	mi³-Ɂia¹²
u¹+lian¹	V;IPFV;PL;1;PST	mi³-u²+lian¹	mi³-u²+lian
Ɂian¹²	V;IPFV;PL;1;PST	mi³-Ɂian¹²	mi³-Ɂian²²
bø²+lḗnɁ²	V;IPFV;PL;1;PST	mi³-bø²+lēnɁ²	mi³-bø²+lēnɁ
mi²+dsian¹²	V;IPFV;PL;1;PST	mi³-mi²+dsian¹³	mi³-mi²+dsian¹
kēn²	V;IPFV;PL;1;PST	mi³-kēn³	mi³-kēn²
kiang¹²	V;IPFV;PL;1;PST	mi³-kiang¹³	mi³-kiang¹²
chiúg²	V;IPFV;PL;1;PST	mi³-chiug¹²	mi³-chiug¹
ɁánɁ²	V;IPFV;PL;1;PST	mi³-ɁanɁ¹²	mi³-ɁanɁ²
ɁlanɁ¹²	V;IPFV;PL;1;PST	mi³-ɁlanɁ¹³	mi³-ɁlanɁ¹²
tiúg²	V;IPFV;PL;1;PST	mi³-tiug¹²	mi³-tiug²
guu²+dsḗn¹³	V;IPFV;PL;1;PST	mi³-guu²+dsēn¹³	mi³-guu²+dsēn¹
guiánɁ¹²	V;IPFV;PL;1;PST	mi³-guianɁ¹²	mi³-guianɁ¹
hlíɁ¹²	V;IPFV;PL;1;PST	mi³-hliɁ²	mi³-hliɁ¹²
Ɂí²	V;IPFV;PL;1;PST	mi³-Ɂu¹²	mi³-Ɂu¹²
séi²	V;IPFV;PL;1;PST	mi³-sei¹²	mi³-sei²
ɁlieɁ¹²	V;IPFV;PL;1;PST	mi³-ɁlieɁ²	mi³-ɁlieɁ²²
huen¹²	V;IPFV;PL;1;PST	mi³-huen¹³	mi³-huen¹³
ieg¹²	V;IPFV;PL;1;PST	mi³-ieg²	mi³-ieg²³
hog¹²	V;IPFV;PL;1;PST	mi³-hog¹²	mi³-hog¹²
køgɁ²	V;IPFV;PL;1;PST	mi³-køgɁ¹²	mi³-køgɁ¹
chiúgɁ²	V;IPFV;PL;1;PST	mi³-chiugɁ³	mi³-chiugɁ³
lan²	V;IPFV;PL;1;PST	mi³-lan²	mi³-lan²
ɁénɁ¹²	V;IPFV;PL;1;PST	mi³-ɁenɁ¹²	mi³-ɁenɁ¹²
tsá¹²	V;IPFV;PL;1;PST	mi³-tsa²	mi³-tsa¹²
siog²	V;IPFV;PL;1;PST	mi³-siog²	mi³-siog²
guiég¹²	V;IPFV;PL;1;PST	mi³-guieg²	mi³-guieg¹²
huu¹²	V;IPFV;PL;1;PST	mi³-huu²	mi³-huu²g
tsíɁ¹²	V;IPFV;PL;1;PST	mi³-tsiɁ¹²	mi³-tsiɁ¹²
tan¹³	V;IPFV;PL;1;PST	mi³-tan¹³	mi³-tan¹³
ɁiíɁ²	V;IPFV;PL;1;PST	mi³-ɁiiɁ¹²	mi³-ɁiiɁ¹
hnóɁ²	V;IPFV;PL;1;PST	mi³-hnoɁ¹²	mi³-hnoɁ³
ɁlíɁ¹²	V;IPFV;PL;1;PST	mi³-ɁliɁ¹²	mi³-ɁliɁ¹²
ku²+guénɁ²	V;IPFV;PL;1;PST	mi³-ku²+guenɁ³	mi³-ku²+guenɁ
hnéi¹²	V;IPFV;PL;1;PST	mi³-hnei²	mi³-hnei¹²
koɁ¹²	V;IPFV;PL;1;PST	mi³-koɁ¹²	mi³-koɁ²²
Ɂán¹² ɁogɁ¹²	V;IPFV;PL;1;PST	mi³-Ɂan¹²	mi³-Ɂan¹²³o³²³
gúɁ¹²	V;IPFV;PL;1;PST	mi³-guɁ²	mi³-guɁ¹²
kionɁ¹²	V;IPFV;PL;1;PST	mi³-kionɁ¹²	mi³-kionɁ¹²
dsi²	V;IPFV;PL;1;PST	mi³-dsi²	mi³-dsi²
mi²+dsiagɁ¹	V;IPFV;PL;1;PST	mi³-mi²+dsiagɁ³	mi³-mi²+dsiagɁ
téng²	V;IPFV;PL;1;PST	mi³-teng²	mi³-teng²
mi²+ti¹	V;IPFV;PL;1;PST	mi³-mi²+ti³	mi³-mi²+ti³
chionɁ¹²	V;IPFV;PL;1;PST	mi³-chionɁ¹³	mi³-chionɁ¹
mi²+lei¹³	V;IPFV;PL;1;PST	mi³-mi²+lei¹³	mi³-mi²+lei¹
mi²+liág¹	V;IPFV;PL;1;PST	mi³-mi²+liag¹³	mi³-mi²+liag
guuɁ¹²	V;IPFV;PL;1;PST	mi³-kieng²	mi³-guuɁ¹²
dsanɁ¹²	V;IPFV;PL;1;PST	mi³-dsanɁ¹²	mi³-dsanɁ¹²
neɁ¹²	V;IPFV;PL;1;PST	mi³-neɁ³	mi³-neɁ³²
mi²+gag¹²	V;IPFV;PL;1;PST	mi³-mi²+gag¹³	mi³-mi²+gag¹
hógɁ¹²	V;IPFV;PL;1;PST	mi³-hogɁ¹²	mi³-hogɁ³²
kieng¹²	V;IPFV;PL;1;PST	mi³-kieng²	mi³-kieng¹²
mi²+dsē¹²	V;IPFV;PL;1;PST	mi³-mi²+dsē¹³	mi³-mi²+dsē¹
hngiú²	V;IPFV;PL;1;PST	mi³-hngiu¹²	mi³-hngiu¹
tei²	V;IPFV;PL;1;PST	mi³-tei³	mi³-tei³
kuø¹²	V;IPFV;PL;1;PST	mi³-kuø²	mi³-kuø²²
kián²	V;IPFV;PL;1;PST	mi³-kian¹²	mi³-kian¹
hiúɁ²	V;IPFV;PL;1;PST	mi³-hioɁ³	mi³-hiuɁ²
dsén²	V;IPFV;PL;1;PST	mi³-dsen²	mi³-dsen¹
ɁiuɁ³ (ɁéɁ¹)	V;IPFV;PL;1;PST	mi³-ɁiuɁ³	mi³-ɁiuɁ³²³¹³³
mi²+huanɁ¹²	V;IPFV;PL;1;PST	mi³-mi²+huanɁ¹³	mi³-mi²+huanɁ¹
ɁiúɁ¹²	V;IPFV;PL;1;PST	mi³-ɁiuɁ³	mi³-ɁiuɁ²²
kiiɁ²	V;IPFV;PL;1;PST	mi³-kiiɁ²	mi³-kiiɁ²
hlǿ²	V;IPFV;PL;1;PST	mi³-hlø¹²	mi³-hlø¹
tan¹²	V;IPFV;PL;1;PST	mi³-tan¹²	mi³-tan¹²
ko¹²	V;IPFV;PL;1;PST	mi³-køg²	mi³-ko²²
tson¹²	V;IPFV;PL;1;PST	mi³-tson¹²	mi³-tson¹²
Ɂen¹³	V;IPFV;PL;1;PST	mi³-Ɂen¹³	mi³-Ɂen¹³
tanɁ¹²	V;IPFV;PL;1;PST	mi³-tianɁ²	mi³-tanɁ¹²
ɁnangɁ²	V;IPFV;PL;1;PST	mi³-ɁniangɁ²	mi³-ɁnangɁ³
hlian¹²	V;IPFV;PL;1;PST	mi³-hlian¹²	mi³-hlian¹²
tion¹²	V;IPFV;PL;1;PST	mi³-tion¹²	mi³-tion¹²
chiógɁ² ( hmøi²)	V;IPFV;PL;1;PST	mi³-chiogɁ³	mi³-chiogɁ³³³³³¹³
Ɂø²+tsóɁ¹²	V;IPFV;PL;1;PST	mi³-Ɂø²+tsoɁ²	mi³-Ɂø²+tsoɁ²
mi²+hngiáng¹	V;IPFV;PL;1;PST	mi³-mi²+hngiang¹³	mi³-mi²+hngian
húg²	V;IPFV;PL;1;PST	mi³-hug²	mi³-hug²
ɁlogɁ²	V;IPFV;PL;1;PST	mi³-ɁlogɁ²	mi³-ɁlogɁ³
mi²+ɁmaɁ¹³	V;IPFV;PL;1;PST	mi³-mi²+ɁmaɁ¹³	mi³-mi²+ɁmaɁ¹
mi²+hog¹²	V;IPFV;PL;1;PST	mi³-mi²+hog³	mi³-mi²+hog³
ɁløaɁ¹²	V;IPFV;PL;1;PST	mi³-ɁløaɁ³	mi³-ɁløaɁ¹²
Ɂiá¹²	V;IPFV;PL;1;PST	mi³-Ɂia¹³	mi³-Ɂia¹²
chiínɁ²	V;IPFV;PL;1;PST	mi³-chienɁ¹²	mi³-chienɁ¹
dsúgɁ¹²	V;IPFV;PL;1;PST	mi³-dsugɁ¹²	mi³-dsugɁ¹²
hnḗ¹²	V;IPFV;PL;1;PST	mi³-hnē¹²	mi³-hnē¹²
ɁóɁ¹²	V;IPFV;PL;1;PST	mi³-ɁoɁ¹²	mi³-ɁoɁ¹²
mi²+Ɂog¹³	V;IPFV;PL;1;PST	mi³-mi²+Ɂog³	mi³-mi²+Ɂog³
dsiánɁ²	V;IPFV;PL;1;PST	mi³-dsianɁ³	mi³-dsianɁ³
lēɁ²	V;IPFV;PL;1;PST	mi³-lēɁ³	mi³-lēɁ³
tsø²+nióɁ²	V;IPFV;PL;1;PST	mi³-tsø²+nioɁ³	mi³-tsø²+nioɁ
mi²+Ɂan¹³	V;IPFV;PL;1;PST	mi³-mi²+Ɂan¹³	mi³-mi²+Ɂan¹
kuú²	V;IPFV;PL;1;PST	mi³-kuu²	mi³-kuu²
iéiɁ¹²	V;IPFV;PL;1;PST	mi³-ieiɁ²	mi³-ieiɁ²²
bá²	V;IPFV;PL;1;PST	mi³-ba¹²	mi³-ba¹²
kon¹²	V;IPFV;PL;1;PST	mi³-kon¹²	mi³-kon¹²
bḗn²	V;IPFV;PL;1;PST	mi³-bēn¹²	mi³-bēn¹
hmo¹²	V;IPFV;PL;1;PST	mi³-hmo²	mi³-hmo²²
nei¹²	V;IPFV;PL;1;PST	mi³-nei³	mi³-nei³²
ɁuanɁ¹²	V;IPFV;PL;1;PST	mi³-ɁuaiɁ¹²	mi³-ɁuanɁ¹²
rang¹²	V;IPFV;PL;1;PST	mi³-rang²	mi³-rang¹²
hiég²	V;IPFV;PL;1;PST	mi³-hieg¹²	mi³-hieg²
kánɁ²	V;IPFV;PL;1;PST	mi³-kanɁ¹²	mi³-kanɁ¹
ɁéɁ¹²	V;IPFV;PL;1;PST	mi³-ɁeɁ¹²	mi³-ɁeɁ¹²
gḗɁ²	V;IPFV;PL;1;PST	mi³-gēɁ²	mi³-gēɁ²
ɁagɁ²	V;IPFV;PL;1;PST	mi³-ɁagɁ³	mi³-ɁagɁ³
háng¹²	V;IPFV;PL;1;PST	mi³-hang³	mi³-hang¹²
nung²	V;IPFV;PL;1;PST	mi³-nung²	mi³-nung²
hniuɁ²	V;IPFV;PL;1;PST	mi³-hniang²	mi³-hniang
ton²	V;IPFV;PL;1;PST	mi³-ton²	mi³-ton²
iaɁ¹²	V;IPFV;PL;1;PST	mi³-iaɁ³	mi³-iaɁ²²
lø²+liugɁ³	V;IPFV;PL;1;PST	mi³-lø²+liugɁ³	mi³-lø²+liugɁ
dsen¹²	V;IPFV;PL;1;PST	mi³-dsen¹²	mi³-dsen¹²
kiúɁ¹²	V;IPFV;PL;1;PST	mi³-kiuɁ²	mi³-kiuɁ³²
kø²+káng¹²	V;IPFV;3;PST	mi³-kø²+káng¹²	mi³-kø²+káng¹
guiágɁ¹²	V;IPFV;3;PST	mi³-guiágɁ¹²	mi³-guiágɁ¹
ɁnóɁ¹² dsí²	V;IPFV;3;PST	mi³-ɁnóɁ¹²	mi³-ɁnóɁ¹²²¹²
dsánɁ¹²	V;IPFV;3;PST	mi³-dsánɁ¹²	mi³-dsánɁ¹²
Ɂuø¹²	V;IPFV;3;PST	mi³-Ɂuø¹²	mi³-Ɂuø¹²
guión²	V;IPFV;3;PST	mi³-guión²	mi³-guión²
lǿɁ²	V;IPFV;3;PST	mi³-lǿɁ²	mi³-lǿɁ²²
tií²	V;IPFV;3;PST	mi³-tií²	mi³-tií²²
guiénɁ²	V;IPFV;3;PST	mi³-guiénɁ²	mi³-guiénɁ²
héinɁ¹²	V;IPFV;3;PST	mi³-héinɁ¹²	mi³-héinɁ¹²
Ɂien¹²	V;IPFV;3;PST	mi³-Ɂien¹²	mi³-Ɂien¹²
hénɁ²	V;IPFV;3;PST	mi³-hénɁ²	mi³-hénɁ²
hǿɁ¹²	V;IPFV;3;PST	mi³-hǿɁ¹²	mi³-hǿɁ¹²
chi²+dsán²	V;IPFV;3;PST	mi³-chi²+dsán²	mi³-chi²+dsán
mi²+dsøg¹²	V;IPFV;3;PST	mi³-mi²+dsøg¹²	mi³-mi²+dsøg¹
guieɁ¹²	V;IPFV;3;PST	mi³-guieɁ¹²	mi³-guieɁ¹²
mi²+chian¹²	V;IPFV;3;PST	mi³-mi²+chian¹²	mi³-mi²+chian
Ɂon¹²	V;IPFV;3;PST	mi³-Ɂon¹²	mi³-Ɂon¹²
niá¹²	V;IPFV;3;PST	mi³-niá¹²	mi³-niá¹²
tangɁ²	V;IPFV;3;PST	mi³-tangɁ²	mi³-tangɁ²
Ɂan¹²	V;IPFV;3;PST	mi³-Ɂan¹²	mi³-Ɂan¹²
dsian¹²	V;IPFV;3;PST	mi³-dsian¹²	mi³-dsian¹²
heinɁ²	V;IPFV;3;PST	mi³-heinɁ²	mi³-heinɁ²
dság¹²	V;IPFV;3;PST	mi³-dság¹²	mi³-dság¹²
hmóngɁ¹²	V;IPFV;3;PST	mi³-hmóngɁ¹²	mi³-hmóngɁ¹
chi²+dsí²	V;IPFV;3;PST	mi³-chi²+dsí²	mi³-chi²+dsí
tsanɁ¹²	V;IPFV;3;PST	mi³-tsanɁ¹²	mi³-tsanɁ¹²
tánɁ¹²	V;IPFV;3;PST	mi³-tánɁ¹²	mi³-tánɁ¹²
kuøin¹²	V;IPFV;3;PST	mi³-kuøin¹²	mi³-kuøin¹²
gógɁ¹²	V;IPFV;3;PST	mi³-gógɁ¹²	mi³-gógɁ¹²
tsø²+nióɁ¹²	V;IPFV;3;PST	mi³-tsø²+nióɁ¹²	mi³-tsø²+nióɁ
ɁuáiɁ¹²	V;IPFV;3;PST	mi³-ɁuáiɁ¹²	mi³-ɁuáiɁ¹²
ti²+líɁ¹	V;IPFV;3;PST	mi³-ti²+líɁ¹	mi³-ti²+líɁ
hánɁ¹²	V;IPFV;3;PST	mi³-hánɁ¹²	mi³-hánɁ¹²
mi²+kiíngɁ²	V;IPFV;3;PST	mi³-mi²+kiíngɁ²	mi³-mi²+kiíng
ɁúgɁ²	V;IPFV;3;PST	mi³-ɁúgɁ²	mi³-ɁúgɁ²
tieɁ¹²	V;IPFV;3;PST	mi³-tieɁ¹²	mi³-tieɁ¹²
chio¹²	V;IPFV;3;PST	mi³-chio¹²	mi³-chio¹²
tian¹²	V;IPFV;3;PST	mi³-tian¹²	mi³-tian¹²
mi²+hmḗ²	V;IPFV;3;PST	mi³-mi²+hmḗ²	mi³-mi²+hmḗ
ngē¹²	V;IPFV;3;PST	mi³-ngē¹²	mi³-ngē¹²
lanɁ¹²	V;IPFV;3;PST	mi³-lanɁ¹²	mi³-lanɁ¹²
tión²	V;IPFV;3;PST	mi³-tión²	mi³-tión²
Ɂøa¹²	V;IPFV;3;PST	mi³-Ɂøa¹²	mi³-Ɂøa¹²
hngiáɁ²	V;IPFV;3;PST	mi³-hngiáɁ²	mi³-hngiáɁ²
ngioɁ¹²	V;IPFV;3;PST	mi³-ngioɁ¹²	mi³-ngioɁ¹²
ɁlianɁ²	V;IPFV;3;PST	mi³-ɁlianɁ²	mi³-ɁlianɁ²
køɁ¹²	V;IPFV;3;PST	mi³-køɁ¹²	mi³-køɁ¹²
tsǿɁ¹²	V;IPFV;3;PST	mi³-tsǿɁ¹²	mi³-tsǿɁ¹²
ta¹²	V;IPFV;3;PST	mi³-ta¹²	mi³-ta¹²³
ha²+Ɂan³	V;IPFV;3;PST	mi³-ha²+Ɂan³	mi³-ha²+Ɂan
kúgɁ¹²	V;IPFV;3;PST	mi³-kúgɁ¹²	mi³-kúgɁ¹²
nioɁ²	V;IPFV;3;PST	mi³-nioɁ²	mi³-nioɁ²
huúɁ¹²	V;IPFV;3;PST	mi³-huúɁ¹²	mi³-huúɁ¹²
kágɁ¹²	V;IPFV;3;PST	mi³-kágɁ¹²	mi³-kágɁ¹²
guái²	V;IPFV;3;PST	mi³-guái²	mi³-guái²
hḗnɁ²	V;IPFV;3;PST	mi³-hḗnɁ²	mi³-hḗnɁ²
ku² hmo¹²	V;IPFV;3;PST	mi³-ku¹²	mi³-ku¹²²n¹²
téiɁ¹²	V;IPFV;3;PST	mi³-téiɁ¹²	mi³-téiɁ¹²
lóɁ¹²	V;IPFV;3;PST	mi³-lóɁ¹²	mi³-lóɁ¹²
tsog¹²	V;IPFV;3;PST	mi³-tsog¹²	mi³-tsog¹²
ngē²	V;IPFV;3;PST	mi³-ngē²	mi³-ngē²¹
mi²+dsēn¹²	V;IPFV;3;PST	mi³-mi²+dsēn¹²	mi³-mi²+dsēn¹
mi²+ɁḗɁ²	V;IPFV;3;PST	mi³-mi²+ɁḗɁ²	mi³-mi²+ɁḗɁ
tø²+ɁénɁ¹²	V;IPFV;3;PST	mi³-tø²+ɁénɁ¹²	mi³-tø²+ɁénɁ¹
ti²+dso¹	V;IPFV;3;PST	mi³-ti²+dso¹	mi³-ti²+dso
rón²	V;IPFV;3;PST	mi³-rón²	mi³-rón²¹
Ɂo¹²	V;IPFV;3;PST	mi³-Ɂo¹²	mi³-Ɂo¹²²
hǿɁ²	V;IPFV;3;PST	mi³-hǿɁ²	mi³-hǿɁ²¹
hnǿ²	V;IPFV;3;PST	mi³-hnǿ²	mi³-hnǿ²¹
hnaiɁ¹²	V;IPFV;3;PST	mi³-hnaiɁ¹²	mi³-hnaiɁ¹²
mi²+tan¹³	V;IPFV;3;PST	mi³-mi²+tan¹³	mi³-mi²+tan¹
ɁuǿɁ¹²	V;IPFV;3;PST	mi³-ɁuǿɁ¹²	mi³-ɁuǿɁ¹²
guønɁ¹²	V;IPFV;3;PST	mi³-guønɁ¹²	mi³-guønɁ¹²
kán²	V;IPFV;3;PST	mi³-kán²	mi³-kán²¹
dsø²+huen¹³	V;IPFV;3;PST	mi³-dsø²+huen¹³	mi³-dsø²+huen
lag²	V;IPFV;3;PST	mi³-lag²	mi³-lag²¹
huú²	V;IPFV;3;PST	mi³-huú²	mi³-huú²¹
bán²	V;IPFV;3;PST	mi³-bán²	mi³-bán²Ɂ
mi²+tég²	V;IPFV;3;PST	mi³-mi²+tég²	mi³-mi²+tég
kiuɁ¹²	V;IPFV;3;PST	mi³-kiuɁ¹²	mi³-kiuɁ¹²
guøn¹²	V;IPFV;3;PST	mi³-guøn¹²	mi³-guøn¹²
ha²	V;IPFV;3;PST	mi³-ha²	mi³-ha²n
len¹²	V;IPFV;3;PST	mi³-len¹²	mi³-len¹²
rǿnɁ¹²	V;IPFV;3;PST	mi³-rǿnɁ¹²	mi³-rǿnɁ¹²
lán¹²	V;IPFV;3;PST	mi³-lán¹²	mi³-lán¹²
niá²	V;IPFV;3;PST	mi³-niá²	mi³-niá²³
Ɂna²	V;IPFV;3;PST	mi³-Ɂna²	mi³-Ɂna²³
Ɂno¹²	V;IPFV;3;PST	mi³-Ɂno¹²	mi³-Ɂno¹²
mi²+kien¹²	V;IPFV;3;PST	mi³-mi²+kien¹²	mi³-mi²+kien¹
chióɁ¹²	V;IPFV;3;PST	mi³-chióɁ¹²	mi³-chióɁ¹²
ngiéɁ¹²	V;IPFV;3;PST	mi³-ngiéɁ¹²	mi³-ngiéɁ¹²
siúg²	V;IPFV;3;PST	mi³-siúg²	mi³-siúg²
dsiag¹²	V;IPFV;3;PST	mi³-dsiag¹²	mi³-dsiag¹²
teng¹²	V;IPFV;3;PST	mi³-teng¹²	mi³-teng¹²
guiónɁ²	V;IPFV;3;PST	mi³-guiónɁ²	mi³-guiónɁ²
mi²+kon¹²	V;IPFV;3;PST	mi³-mi²+kon¹²	mi³-mi²+kon¹
hanɁ¹² dsǿa¹²	V;IPFV;3;PST	mi³-hanɁ¹²	mi³-hanɁ¹²¹²²³
méɁ²	V;IPFV;3;PST	mi³-méɁ²	mi³-méɁ²²
ngié²	V;IPFV;3;PST	mi³-ngié²	mi³-ngié²
tsogɁ² hmøi²	V;IPFV;3;PST	mi³-tsogɁ²	mi³-tsogɁ²²ú¹²
hnio³	V;IPFV;3;PST	mi³-hnio³	mi³-hnio³
Ɂngio¹²	V;IPFV;3;PST	mi³-Ɂngio¹²	mi³-Ɂngio¹²
ténɁ¹²	V;IPFV;3;PST	mi³-ténɁ¹²	mi³-ténɁ¹²
tán¹²	V;IPFV;3;PST	mi³-tán¹²	mi³-tán¹²
tson²	V;IPFV;3;PST	mi³-tson²	mi³-tson²
hen¹²	V;IPFV;3;PST	mi³-hen¹²	mi³-hen¹²
huǿin¹²	V;IPFV;3;PST	mi³-huǿin¹²	mi³-huǿin¹²
tsón¹²	V;IPFV;3;PST	mi³-tsón¹²	mi³-tsón¹²
kii²+túg²	V;IPFV;3;PST	mi³-kii²+túg²	mi³-kii²+túg
kii²+tág¹²	V;IPFV;3;PST	mi³-kii²+tág¹²	mi³-kii²+tág¹
hngia¹²	V;IPFV;3;PST	mi³-hngia¹²	mi³-hngia¹²
dsoɁ²	V;IPFV;3;PST	mi³-dsoɁ²	mi³-dsoɁ²
Ɂán²	V;IPFV;3;PST	mi³-Ɂán²	mi³-Ɂán²³
køn¹²	V;IPFV;3;PST	mi³-køn¹²	mi³-køn¹²
Ɂiog²	V;IPFV;3;PST	mi³-Ɂiog²	mi³-Ɂiog²
tsog²	V;IPFV;3;PST	mi³-tsog²	mi³-tsog²
kugɁ¹²	V;IPFV;3;PST	mi³-kugɁ¹²	mi³-kugɁ¹²
tsǿaɁ¹²	V;IPFV;3;PST	mi³-tsǿaɁ¹²	mi³-tsǿaɁ¹²
hne¹²	V;IPFV;3;PST	mi³-hne¹²	mi³-hne¹²
ɁioɁ¹²	V;IPFV;3;PST	mi³-ɁioɁ¹²	mi³-ɁioɁ¹²
tsǿng²	V;IPFV;3;PST	mi³-tsǿng²	mi³-tsǿng²
hmóɁ¹²	V;IPFV;3;PST	mi³-hmóɁ¹²	mi³-hmóɁ¹²
hngie¹²	V;IPFV;3;PST	mi³-hngie¹²	mi³-hngie¹²
nēɁ¹²	V;IPFV;3;PST	mi³-nēɁ¹²	mi³-nēɁ¹²
húɁ²	V;IPFV;3;PST	mi³-húɁ²	mi³-húɁ²¹
huɁ¹²	V;IPFV;3;PST	mi³-huɁ¹²	mi³-huɁ¹²
Ɂnia¹²	V;IPFV;3;PST	mi³-Ɂnia¹²	mi³-Ɂnia¹²
héin¹²	V;IPFV;3;PST	mi³-héin¹²	mi³-héin¹²
hleɁ¹²	V;IPFV;3;PST	mi³-hleɁ¹²	mi³-hleɁ¹²
dsúgɁ²	V;IPFV;3;PST	mi³-dsúgɁ²	mi³-dsúgɁ²
nióɁ¹²	V;IPFV;3;PST	mi³-nióɁ¹²	mi³-nióɁ¹²
ngie¹²	V;IPFV;3;PST	mi³-ngie¹²	mi³-ngie¹²
dsiánɁ¹²	V;IPFV;3;PST	mi³-dsiánɁ¹²	mi³-dsiánɁ¹
Ɂiag²	V;IPFV;3;PST	mi³-Ɂiag²	mi³-Ɂiag²
kieg²	V;IPFV;3;PST	mi³-kieg²	mi³-kieg²
køin²	V;IPFV;3;PST	mi³-køin²	mi³-køin²
chiáng¹²	V;IPFV;3;PST	mi³-chiáng¹²	mi³-chiáng¹
kióɁ¹²	V;IPFV;3;PST	mi³-kióɁ¹²	mi³-kióɁ¹²
Ɂlúg²	V;IPFV;3;PST	mi³-Ɂlúg²	mi³-Ɂlúg²
møa¹²	V;IPFV;3;PST	mi³-møa¹²	mi³-møa¹²
guen²	V;IPFV;3;PST	mi³-guen²	mi³-guen²
tug	V;IPFV;3;PST	mi³-tug¹²	mi³-tug¹
hngēɁ¹²	V;IPFV;3;PST	mi³-hngēɁ¹²	mi³-hngēɁ¹²
dsie¹²	V;IPFV;3;PST	mi³-dsie¹²	mi³-dsie¹²
tsénɁ²	V;IPFV;3;PST	mi³-tsénɁ²	mi³-tsénɁ²
chiunɁ¹²	V;IPFV;3;PST	mi³-chiunɁ¹²	mi³-chiunɁ¹
tióɁ¹²	V;IPFV;3;PST	mi³-tióɁ¹²	mi³-tióɁ¹²
tø²+húg³	V;IPFV;3;PST	mi³-tø²+húg³	mi³-tø²+húg
mi²+Ɂlí¹	V;IPFV;3;PST	mi³-mi²+Ɂlí¹	mi³-mi²+Ɂlí
niúɁ²	V;IPFV;3;PST	mi³-niúɁ²	mi³-niúɁ²
chi²+lánɁ²	V;IPFV;3;PST	mi³-chi²+lánɁ²	mi³-chi²+lánɁ
Ɂén²	V;IPFV;3;PST	mi³-Ɂén²	mi³-Ɂén²³
tsø²+kuønɁ¹²	V;IPFV;3;PST	mi³-tsø²+kuønɁ¹²	mi³-tsø²+kuønɁ
uǿi²	V;IPFV;3;PST	mi³-uǿi²	mi³-uǿi²²
mi²+kuuɁ¹²	V;IPFV;3;PST	mi³-mi²+kuuɁ¹²	mi³-mi²+kuuɁ¹
mi²+níɁ¹	V;IPFV;3;PST	mi³-mi²+níɁ¹	mi³-mi²+níɁ
búɁ²	V;IPFV;3;PST	mi³-búɁ²	mi³-búɁ²²
niuɁ³	V;IPFV;3;PST	mi³-niuɁ³	mi³-niuɁ³
dsa²	V;IPFV;3;PST	mi³-dsa²	mi³-dsa²¹
tsø²+han¹²	V;IPFV;3;PST	mi³-tsø²+han¹²	mi³-tsø²+han¹
hḗn²	V;IPFV;3;PST	mi³-hḗn²	mi³-hḗn²¹
ngai¹²	V;IPFV;3;PST	mi³-ngai¹²	mi³-ngai¹²
mi²+hngió¹	V;IPFV;3;PST	mi³-mi²+hngió¹	mi³-mi²+hngió
chión²	V;IPFV;3;PST	mi³-chión²	mi³-chión²
guianɁ¹²	V;IPFV;3;PST	mi³-guianɁ²	mi³-guianɁ¹
hmḗɁ²	V;IPFV;3;PST	mi³-hmḗɁ²	mi³-hmḗɁ²
Ɂiog¹²	V;IPFV;3;PST	mi³-Ɂiog¹²	mi³-Ɂiog¹²
dsø²+togɁ¹²	V;IPFV;3;PST	mi³-dsø²+togɁ¹²	mi³-dsø²+togɁ
mi²+dsíg²	V;IPFV;3;PST	mi³-mi²+dsíg²	mi³-mi²+dsíg
tǿɁ²	V;IPFV;3;PST	mi³-tǿɁ²	mi³-tǿɁ²¹
huúɁ²	V;IPFV;3;PST	mi³-huúɁ²	mi³-huúɁ²
mi²+gan¹²	V;IPFV;3;PST	mi³-mi²+gan¹²	mi³-mi²+gan¹
lieɁ¹²	V;IPFV;3;PST	mi³-lieɁ¹²	mi³-lieɁ¹²
ɁiéiɁ¹²	V;IPFV;3;PST	mi³-ɁiéiɁ¹²	mi³-ɁiéiɁ¹²
ti²+dsǿ²	V;IPFV;3;PST	mi³-ti²+dsǿ²	mi³-ti²+dsǿ
chiag¹²	V;IPFV;3;PST	mi³-chiag¹²	mi³-chiag¹²
guen¹²	V;IPFV;3;PST	mi³-guen¹²	mi³-guen¹²
mi²+hǿ²	V;IPFV;3;PST	mi³-mi²+hǿ²	mi³-mi²+hǿ²
tónɁ² (huu¹²)	V;IPFV;3;PST	mi³-tónɁ²	mi³-tónɁ²²²Ɂ¹(
mi²+kánɁ²	V;IPFV;3;PST	mi³-mi²+kánɁ²	mi³-mi²+kánɁ
Ɂuan¹²	V;IPFV;3;PST	mi³-Ɂuan¹²	mi³-Ɂuan¹²
Ɂúg²	V;IPFV;3;PST	mi³-Ɂúg²	mi³-Ɂúg²¹
kēnɁ¹²	V;IPFV;3;PST	mi³-kēnɁ¹²	mi³-kēnɁ¹²
tsiɁ¹²	V;IPFV;3;PST	mi³-tsiɁ¹²	mi³-tsiɁ¹²
kiéɁ¹²	V;IPFV;3;PST	mi³-kiéɁ¹²	mi³-kiéɁ¹²
tsánɁ²	V;IPFV;3;PST	mi³-tsánɁ²	mi³-tsánɁ²
bén²	V;IPFV;3;PST	mi³-bén²	mi³-bén²³
ngiú²	V;IPFV;3;PST	mi³-ngiú²	mi³-ngiú²
lúg²	V;IPFV;3;PST	mi³-lúg²	mi³-lúg²¹
tag¹²	V;IPFV;3;PST	mi³-tag¹²	mi³-tag¹²
ɁiánɁ²	V;IPFV;3;PST	mi³-ɁiánɁ²	mi³-ɁiánɁ²
mi²+Ɂai¹	V;IPFV;3;PST	mi³-mi²+Ɂai¹	mi³-mi²+Ɂai
kǿ²	V;IPFV;3;PST	mi³-kǿ²	mi³-kǿ²i
tsí¹²	V;IPFV;3;PST	mi³-tsí¹²	mi³-tsí¹²
lan¹²	V;IPFV;3;PST	mi³-lan¹²	mi³-lan¹²
kiog¹²	V;IPFV;3;PST	mi³-kiog¹²	mi³-kiog¹²
chi²+dsén²	V;IPFV;3;PST	mi³-chi²+dsén²	mi³-chi²+dsén
hlán²	V;IPFV;3;PST	mi³-hlán²	mi³-hlán²
u¹+lén²	V;IPFV;3;PST	mi³-u²+lén²	mi³-u²+lén²
tsen¹²	V;IPFV;3;PST	mi³-tsen¹²	mi³-tsen¹²
dsan²	V;IPFV;3;PST	mi³-dsan²	mi³-dsan²
ɁónɁ²	V;IPFV;3;PST	mi³-ɁónɁ²	mi³-ɁónɁ²
hliúg² (lag³ dsi³)	V;IPFV;3;PST	mi³-hliúg²	mi³-hliúg²²Ɂg³¹(((
hmáɁ² (ta³)	V;IPFV;3;PST	mi³-hmáɁ²	mi³-hmáɁ²²²g¹
lø²+liúɁ²	V;IPFV;3;PST	mi³-lø²+liúɁ²	mi³-lø²+liúɁ
ha¹²	V;IPFV;3;PST	mi³-ha¹²	mi³-ha¹²³
guian¹²	V;IPFV;3;PST	mi³-guian¹²	mi³-guian¹²
ti²+li¹	V;IPFV;3;PST	mi³-ti²+li¹	mi³-ti²+li¹
mi²+ngḗɁ¹	V;IPFV;3;PST	mi³-mi²+ngḗɁ¹	mi³-mi²+ngḗɁ
guiúnɁ¹²	V;IPFV;3;PST	mi³-guiúnɁ¹²	mi³-guiúnɁ¹
mi²+kuen¹²	V;IPFV;3;PST	mi³-mi²+kuen¹²	mi³-mi²+kuen¹
hngiíɁ²	V;IPFV;3;PST	mi³-hngiíɁ²	mi³-hngiíɁ²
mi²+gǿg¹	V;IPFV;3;PST	mi³-mi²+gǿg¹	mi³-mi²+gǿg
kanɁ¹²	V;IPFV;3;PST	mi³-kanɁ¹²	mi³-kanɁ¹²
Ɂmǿi²	V;IPFV;3;PST	mi³-Ɂmǿi²	mi³-Ɂmǿi²
chi²+ngió²	V;IPFV;3;PST	mi³-chi²+ngió²	mi³-chi²+ngió
ti²+dsiog¹	V;IPFV;3;PST	mi³-ti²+dsiog¹	mi³-ti²+dsiog
liág¹	V;IPFV;3;PST	mi³-liág¹	mi³-liág¹
Ɂǿng²	V;IPFV;3;PST	mi³-Ɂǿng²	mi³-Ɂǿng²
Ɂngieng¹²	V;IPFV;3;PST	mi³-Ɂngieng¹²	mi³-Ɂngieng¹
hné¹²	V;IPFV;3;PST	mi³-hné¹²	mi³-hné¹²
gǿi¹²	V;IPFV;3;PST	mi³-gǿi¹²	mi³-gǿi¹²
tsón²	V;IPFV;3;PST	mi³-tsón²	mi³-tsón²
húgɁ²	V;IPFV;3;PST	mi³-húgɁ²	mi³-húgɁ²
mái¹²	V;IPFV;3;PST	mi³-mái¹²	mi³-mái¹²
kiáɁ²	V;IPFV;3;PST	mi³-kiáɁ²	mi³-kiáɁ²
mi²+rø¹²	V;IPFV;3;PST	mi³-mi²+rø¹²	mi³-mi²+rø¹
tiú²	V;IPFV;3;PST	mi³-tiú²	mi³-tiú²¹
dsogɁ¹²	V;IPFV;3;PST	mi³-dsogɁ¹²	mi³-dsogɁ¹²
hiugɁ¹²	V;IPFV;3;PST	mi³-hiugɁ¹²	mi³-hiugɁ¹²
kian¹²	V;IPFV;3;PST	mi³-kian¹²	mi³-kian¹²
Ɂngiéng¹²	V;IPFV;3;PST	mi³-Ɂngiéng¹²	mi³-Ɂngiéng¹
tián²	V;IPFV;3;PST	mi³-tián²	mi³-tián²
ɁnáɁ¹²	V;IPFV;3;PST	mi³-ɁnáɁ¹²	mi³-ɁnáɁ¹²
ɁliuɁ¹²	V;IPFV;3;PST	mi³-ɁliuɁ¹²	mi³-ɁliuɁ¹²
tso¹²	V;IPFV;3;PST	mi³-tso¹²	mi³-tso¹²
siég²	V;IPFV;3;PST	mi³-siég²	mi³-siég²
kien¹²	V;IPFV;3;PST	mi³-kien¹²	mi³-kien¹²
tsén²	V;IPFV;3;PST	mi³-tsén²	mi³-tsén²
Ɂuu²	V;IPFV;3;PST	mi³-Ɂuu²	mi³-Ɂuu²³
ngēɁ² dsǿa¹²	V;IPFV;3;PST	mi³-ngēɁ²	mi³-ngēɁ²²²¹g²
mi²+hniang¹ ni³	V;IPFV;3;PST	mi³-mi²+hniang¹	mi³-mi²+hniang¹¹
mi²+guionɁ¹	V;IPFV;3;PST	mi³-mi²+guionɁ¹	mi³-mi²+guion
kúgɁ²	V;IPFV;3;PST	mi³-kúgɁ²	mi³-kúgɁ²
Ɂma¹²	V;IPFV;3;PST	mi³-Ɂma¹²	mi³-Ɂma¹²
chiágɁ¹²	V;IPFV;3;PST	mi³-chiágɁ¹²	mi³-chiágɁ¹
tø²+kanɁ¹³	V;IPFV;3;PST	mi³-tø²+kanɁ¹³	mi³-tø²+kanɁ¹
ngáɁ¹²	V;IPFV;3;PST	mi³-ngáɁ¹²	mi³-ngáɁ¹²
ɁiúɁ²	V;IPFV;3;PST	mi³-ɁiúɁ²	mi³-ɁiúɁ²
mi²+Ɂliúg²	V;IPFV;3;PST	mi³-mi²+Ɂliúg²	mi³-mi²+Ɂliúg
tóɁ¹²	V;IPFV;3;PST	mi³-tóɁ¹²	mi³-tóɁ¹²
tanɁ¹² huu¹²	V;IPFV;3;PST	mi³-tanɁ¹²	mi³-tanɁ¹²²²¹g
kán² guiing²	V;IPFV;3;PST	mi³-kán²	mi³-kán²gɁ²²ág
Ɂug¹²	V;IPFV;3;PST	mi³-Ɂug¹²	mi³-Ɂug¹²
ián²	V;IPFV;3;PST	mi³-ián²	mi³-ián²¹
hén²	V;IPFV;3;PST	mi³-hén²	mi³-hén²¹
mi²+Ɂan¹²	V;IPFV;3;PST	mi³-mi²+Ɂan¹²	mi³-mi²+Ɂan¹
dsēn¹²	V;IPFV;3;PST	mi³-dsēn¹²	mi³-dsēn¹²
hngieng¹²	V;IPFV;3;PST	mi³-hngieng²	mi³-hngieng¹
tsai¹²	V;IPFV;3;PST	mi³-tsai¹²	mi³-tsai¹²
lá¹²	V;IPFV;3;PST	mi³-lá¹²	mi³-lá¹²¹
bí²	V;IPFV;3;PST	mi³-bí²	mi³-bí²e
Ɂø²+tsúgɁ²	V;IPFV;3;PST	mi³-Ɂø²+tsúgɁ²	mi³-Ɂø²+tsúgɁ
hngii²	V;IPFV;3;PST	mi³-hngii²	mi³-hngii²
mi²+kiín¹	V;IPFV;3;PST	mi³-mi²+kiín¹	mi³-mi²+kiín
hønɁ¹²	V;IPFV;3;PST	mi³-hønɁ¹²	mi³-hønɁ¹²
tsøi¹²	V;IPFV;3;PST	mi³-tsøi¹²	mi³-tsøi¹²
kuǿɁ¹²	V;IPFV;3;PST	mi³-kuǿɁ¹²	mi³-kuǿɁ¹²
Ɂuǿi²	V;IPFV;3;PST	mi³-Ɂuǿi²	mi³-Ɂuǿi²
taɁ²	V;IPFV;3;PST	mi³-taɁ²	mi³-taɁ²³
tiánɁ¹²	V;IPFV;3;PST	mi³-tiánɁ¹²	mi³-tiánɁ¹²
hnióɁ²	V;IPFV;3;PST	mi³-hnióɁ²	mi³-hnióɁ²
tsenɁ¹²	V;IPFV;3;PST	mi³-tsenɁ¹²	mi³-tsenɁ¹²
guieng¹²	V;IPFV;3;PST	mi³-guieng¹²	mi³-guieng¹
ɁǿnɁ²	V;IPFV;3;PST	mi³-ɁǿnɁ²	mi³-ɁǿnɁ²
Ɂe¹²	V;IPFV;3;PST	mi³-Ɂe¹²	mi³-Ɂe¹²²
ngó¹²	V;IPFV;3;PST	mi³-ngó¹²	mi³-ngó¹²
chiángɁ¹²	V;IPFV;3;PST	mi³-chiángɁ¹²	mi³-chiángɁ¹
mē¹²	V;IPFV;3;PST	mi³-mē¹²	mi³-mē¹²¹
mi²+kiónɁ²	V;IPFV;3;PST	mi³-mi²+kiónɁ²	mi³-mi²+kiónɁ
kiagɁ¹²	V;IPFV;3;PST	mi³-kiagɁ¹²	mi³-kiagɁ¹²
lio¹²	V;IPFV;3;PST	mi³-lio¹²	mi³-lio¹²
ɁmóɁ²	V;IPFV;3;PST	mi³-ɁmóɁ²	mi³-ɁmóɁ²
hniang²	V;IPFV;3;PST	mi³-hniang²	mi³-hniang²
tian¹	V;IPFV;3;PST	mi³-tian¹	mi³-tian¹
dsii²+lei¹	V;IPFV;3;PST	mi³-dsii²+lei¹	mi³-dsii²+lei
ɁmēɁ¹²	V;IPFV;3;PST	mi³-ɁmēɁ¹²	mi³-ɁmēɁ¹²
mi²+hní¹	V;IPFV;3;PST	mi³-mi²+hní¹	mi³-mi²+hní
nié¹²	V;IPFV;3;PST	mi³-nié¹²	mi³-nié¹²
hngióɁ²	V;IPFV;3;PST	mi³-hngióɁ²	mi³-hngióɁ²
ɁenɁ¹²	V;IPFV;3;PST	mi³-ɁenɁ¹²	mi³-ɁenɁ¹²
Ɂig²	V;IPFV;3;PST	mi³-Ɂig²	mi³-Ɂig²¹
tsēnɁ¹²	V;IPFV;3;PST	mi³-tsēnɁ¹²	mi³-tsēnɁ¹²
ɁøɁ¹²	V;IPFV;3;PST	mi³-ɁøɁ¹²	mi³-ɁøɁ¹²
mḗɁ²	V;IPFV;3;PST	mi³-mḗɁ²	mi³-mḗɁ²²
kang²	V;IPFV;3;PST	mi³-kang²	mi³-kang²
ngǿi²	V;IPFV;3;PST	mi³-ngǿi²	mi³-ngǿi²
hḗɁ²	V;IPFV;3;PST	mi³-hḗɁ²	mi³-hḗɁ²¹
kø²+hinɁ¹²	V;IPFV;3;PST	mi³-kø²+hinɁ¹²	mi³-kø²+hinɁ¹
siógɁ¹²	V;IPFV;3;PST	mi³-siógɁ¹²	mi³-siógɁ¹²
guenɁ¹²	V;IPFV;3;PST	mi³-guenɁ¹²	mi³-guenɁ¹²
hénɁ¹²	V;IPFV;3;PST	mi³-hénɁ¹²	mi³-hénɁ¹²
ti²+kḗn¹	V;IPFV;3;PST	mi³-ti²+kḗn¹	mi³-ti²+kḗn
siúgɁ²	V;IPFV;3;PST	mi³-siúgɁ²	mi³-siúgɁ²
hnáɁ¹²	V;IPFV;3;PST	mi³-hnáɁ¹²	mi³-hnáɁ¹²
lánɁ²	V;IPFV;3;PST	mi³-lánɁ²	mi³-lánɁ²
ngie³	V;IPFV;3;PST	mi³-ngie¹²	mi³-ngie³
ngieɁ¹³	V;IPFV;3;PST	mi³-ngieɁ¹³	mi³-ngieɁ¹³
tsøg²	V;IPFV;3;PST	mi³-tsøg²	mi³-tsøg²
lióg¹²	V;IPFV;3;PST	mi³-lióg¹²	mi³-lióg¹²
mi²+gan¹	V;IPFV;3;PST	mi³-mi²+gan¹	mi³-mi²+gan
dságɁ¹²	V;IPFV;3;PST	mi³-dságɁ¹²	mi³-dságɁ¹²
Ɂian²	V;IPFV;3;PST	mi³-Ɂian²	mi³-Ɂian²
ɁliágɁ¹²	V;IPFV;3;PST	mi³-ɁliágɁ¹²	mi³-ɁliágɁ¹
ɁéɁ²	V;IPFV;3;PST	mi³-ɁéɁ²	mi³-ɁéɁ²²
Ɂnai¹²	V;IPFV;3;PST	mi³-Ɂnai¹²	mi³-Ɂnai¹²
guienɁ¹²	V;IPFV;3;PST	mi³-guienɁ¹²	mi³-guienɁ¹
hngió²	V;IPFV;3;PST	mi³-hngió²	mi³-hngió²
kiugɁ²	V;IPFV;3;PST	mi³-kiugɁ²	mi³-kiugɁ²
chióg¹²	V;IPFV;3;PST	mi³-chióg¹²	mi³-chióg¹²
Ɂme¹²	V;IPFV;3;PST	mi³-Ɂme¹²	mi³-Ɂme¹²
Ɂmóng¹²	V;IPFV;3;PST	mi³-Ɂmóng¹²	mi³-Ɂmóng¹²
mi²+hu¹	V;IPFV;3;PST	mi³-mi²+hu¹	mi³-mi²+hu¹
Ɂia¹²	V;IPFV;3;PST	mi³-Ɂia¹²	mi³-Ɂia¹²
u¹+lian¹	V;IPFV;3;PST	mi³-u²+lian¹	mi³-u²+lian
kógɁ¹²	V;IPFV;3;PST	mi³-kógɁ¹²	mi³-kógɁ¹²
dsan¹²	V;IPFV;3;PST	mi³-dsan¹²	mi³-dsan¹²
hlø²	V;IPFV;3;PST	mi³-hlø²	mi³-hlø²¹
guø¹²	V;IPFV;3;PST	mi³-guø¹²	mi³-guø¹²
tø²+dsḗn³	V;IPFV;3;PST	mi³-tø²+dsḗn³	mi³-tø²+dsḗn
mi²+dsian¹²	V;IPFV;3;PST	mi³-mi²+dsian¹²	mi³-mi²+dsian
kiang¹²	V;IPFV;3;PST	mi³-kiang¹²	mi³-kiang¹²
chiúg²	V;IPFV;3;PST	mi³-chiúg²	mi³-chiúg²
ɁánɁ²	V;IPFV;3;PST	mi³-ɁánɁ²	mi³-ɁánɁ²
tiúg²	V;IPFV;3;PST	mi³-tiúg²	mi³-tiúg²
guu²+dsḗn¹³	V;IPFV;3;PST	mi³-guu²+dsḗn¹³	mi³-guu²+dsḗn
guiánɁ¹²	V;IPFV;3;PST	mi³-guiánɁ¹²	mi³-guiánɁ¹
Ɂein¹³	V;IPFV;3;PST	mi³-Ɂein¹³	mi³-Ɂein¹³
hniá¹²	V;IPFV;3;PST	mi³-hniá¹²	mi³-hniá¹²
hlíɁ¹²	V;IPFV;3;PST	mi³-hlíɁ¹²	mi³-hlíɁ¹²
ieg¹²	V;IPFV;3;PST	mi³-ieg¹²	mi³-ieg¹²
ngoɁ³	V;IPFV;3;PST	mi³-ngoɁ³	mi³-ngoɁ³
rain¹²	V;IPFV;3;PST	mi³-rain¹²	mi³-rain¹²
hog¹²	V;IPFV;3;PST	mi³-hog¹²	mi³-hog¹²
køgɁ²	V;IPFV;3;PST	mi³-køgɁ²	mi³-køgɁ²
chiúgɁ²	V;IPFV;3;PST	mi³-chiúgɁ²	mi³-chiúgɁ²
lái¹²	V;IPFV;3;PST	mi³-lái¹²	mi³-lái¹²
lan²	V;IPFV;3;PST	mi³-lan²	mi³-lan²³
ɁénɁ¹²	V;IPFV;3;PST	mi³-ɁénɁ¹²	mi³-ɁénɁ¹²
ha²+lei¹	V;IPFV;3;PST	mi³-ha²+lei¹	mi³-ha²+lei
tsá¹²	V;IPFV;3;PST	mi³-tsá¹²	mi³-tsá¹²
guiang¹²	V;IPFV;3;PST	mi³-guiang¹²	mi³-guiang¹
kuan¹²	V;IPFV;3;PST	mi³-kuan¹²	mi³-kuan¹²
siog²	V;IPFV;3;PST	mi³-siog²	mi³-siog²
gúgɁ¹² dsǿa¹²	V;IPFV;3;PST	mi³-gúgɁ¹²	mi³-gúgɁ¹²²¹²³
guiég¹²	V;IPFV;3;PST	mi³-guiég¹²	mi³-guiég¹²
huu¹²	V;IPFV;3;PST	mi³-huu¹²	mi³-huu¹²
tsíɁ¹²	V;IPFV;3;PST	mi³-tsíɁ²	mi³-tsíɁ¹²
hí²	V;IPFV;3;PST	mi³-hí²	mi³-hí²a
Ɂéng²	V;IPFV;3;PST	mi³-Ɂéng²	mi³-Ɂéng²
tan¹³	V;IPFV;3;PST	mi³-tan¹³	mi³-tan¹³
ɁiíɁ²	V;IPFV;3;PST	mi³-ɁiíɁ²	mi³-ɁiíɁ²
ku²+guénɁ²	V;IPFV;3;PST	mi³-ku²+guénɁ²	mi³-ku²+guénɁ
hnéi¹²	V;IPFV;3;PST	mi³-hnéi¹²	mi³-hnéi¹²
koɁ¹²	V;IPFV;3;PST	mi³-koɁ¹²	mi³-koɁ¹²
Ɂán¹² ɁogɁ¹²	V;IPFV;3;PST	mi³-Ɂán¹²	mi³-Ɂán¹²²²é¹²
gúɁ¹²	V;IPFV;3;PST	mi³-gúɁ¹²	mi³-gúɁ¹²
bēn¹²	V;IPFV;3;PST	mi³-bēn¹²	mi³-bēn¹²
mi²+dsiagɁ¹	V;IPFV;3;PST	mi³-mi²+dsiagɁ¹	mi³-mi²+dsiag
téng²	V;IPFV;3;PST	mi³-téng²	mi³-téng²
mi²+ti¹	V;IPFV;3;PST	mi³-mi²+ti¹	mi³-mi²+ti¹
chionɁ¹²	V;IPFV;3;PST	mi³-chionɁ¹²	mi³-chionɁ¹
ngēɁ²	V;IPFV;3;PST	mi³-ngēɁ²	mi³-ngēɁ²
mi²+lei¹³	V;IPFV;3;PST	mi³-mi²+lei¹³	mi³-mi²+lei¹
tógɁ¹²	V;IPFV;3;PST	mi³-tógɁ¹²	mi³-tógɁ¹²
mi²+liág¹	V;IPFV;3;PST	mi³-mi²+liág¹	mi³-mi²+liág
guuɁ¹²	V;IPFV;3;PST	mi³-guuɁ¹²	mi³-guuɁ¹²
dsanɁ¹²	V;IPFV;3;PST	mi³-dsanɁ¹²	mi³-dsanɁ¹²
téiɁ²	V;IPFV;3;PST	mi³-téiɁ²	mi³-téiɁ²
mi²+gag¹²	V;IPFV;3;PST	mi³-mi²+gag¹²	mi³-mi²+gag¹
hógɁ¹²	V;IPFV;3;PST	mi³-hógɁ¹²	mi³-hógɁ¹²
kieng¹²	V;IPFV;3;PST	mi³-kieng¹²	mi³-kieng¹²
mi²+dsē¹²	V;IPFV;3;PST	mi³-mi²+dsē¹²	mi³-mi²+dsē¹
hngiú²	V;IPFV;3;PST	mi³-hngiú²	mi³-hngiú²
kuø¹²	V;IPFV;3;PST	mi³-kuø¹²	mi³-kuø¹²
dsén²	V;IPFV;3;PST	mi³-dsén²	mi³-dsén²
ɁiuɁ³ (ɁéɁ¹)	V;IPFV;3;PST	mi³-ɁiuɁ³	mi³-ɁiuɁ³²²g¹²
mi²+huanɁ¹²	V;IPFV;3;PST	mi³-mi²+huanɁ¹²	mi³-mi²+huanɁ
hǿa¹²	V;IPFV;3;PST	mi³-hǿa¹²	mi³-hǿa¹²
hlíɁ²	V;IPFV;3;PST	mi³-hlíɁ²	mi³-hlíɁ²
kiiɁ²	V;IPFV;3;PST	mi³-kiiɁ²	mi³-kiiɁ²
tan¹²	V;IPFV;3;PST	mi³-tan¹²	mi³-tan¹²
ko¹²	V;IPFV;3;PST	mi³-ko¹²	mi³-ko¹²¹
ti²+dsøa¹²	V;IPFV;3;PST	mi³-ti²+dsøa¹²	mi³-ti²+dsøa¹
len¹² dsǿa¹²	V;IPFV;3;PST	mi³-len¹²	mi³-len¹²m²²Ɂ²
tson¹²	V;IPFV;3;PST	mi³-tson¹²	mi³-tson¹²
han¹²	V;IPFV;3;PST	mi³-han¹²	mi³-han¹²
Ɂøin¹²	V;IPFV;3;PST	mi³-Ɂøin¹²	mi³-Ɂøin¹²
dsióɁ¹² hǿg³	V;IPFV;3;PST	mi³-dsióɁ¹²	mi³-dsióɁ¹²²Ɂ¹
chi²+láɁ²	V;IPFV;3;PST	mi³-chi²+láɁ²	mi³-chi²+láɁ
hai¹²	V;IPFV;3;PST	mi³-hai¹²	mi³-hai¹²
ngángɁ¹²	V;IPFV;3;PST	mi³-ngángɁ¹²	mi³-ngángɁ¹
Ɂen¹³	V;IPFV;3;PST	mi³-Ɂen¹³	mi³-Ɂen¹³
tanɁ¹²	V;IPFV;3;PST	mi³-tanɁ¹²	mi³-tanɁ¹²
gøi²	V;IPFV;3;PST	mi³-gøi²	mi³-gøi²³
ɁnangɁ²	V;IPFV;3;PST	mi³-ɁnangɁ²	mi³-ɁnangɁ²
tion¹²	V;IPFV;3;PST	mi³-tion¹²	mi³-tion¹²
ɁáiɁ¹²	V;IPFV;3;PST	mi³-ɁáiɁ¹²	mi³-ɁáiɁ¹²
hlénɁ²	V;IPFV;3;PST	mi³-hlénɁ²	mi³-hlénɁ²
chiógɁ² ( hmøi²)	V;IPFV;3;PST	mi³-chiógɁ²	mi³-chiógɁ²¹²²²¹
Ɂø²+tsóɁ¹²	V;IPFV;3;PST	mi³-Ɂø²+tsóɁ¹²	mi³-Ɂø²+tsóɁ¹
laiɁ¹²	V;IPFV;3;PST	mi³-laiɁ¹²	mi³-laiɁ¹²
nøɁ¹²	V;IPFV;3;PST	mi³-nøɁ¹²	mi³-nøɁ¹²
mi²+hngiáng¹	V;IPFV;3;PST	mi³-mi²+hngiáng¹	mi³-mi²+hngián
Ɂlí²	V;IPFV;3;PST	mi³-Ɂlí²	mi³-Ɂlí²²
húg²	V;IPFV;3;PST	mi³-húg²	mi³-húg²¹
neng²	V;IPFV;3;PST	mi³-neng²	mi³-neng²
ɁlogɁ²	V;IPFV;3;PST	mi³-ɁlogɁ²	mi³-ɁlogɁ²
siág¹²	V;IPFV;3;PST	mi³-siág¹²	mi³-siág¹²
Ɂlen¹²	V;IPFV;3;PST	mi³-Ɂlen¹²	mi³-Ɂlen¹²
ɁoɁ¹²	V;IPFV;3;PST	mi³-ɁoɁ¹²	mi³-ɁoɁ¹²
dsiog¹²	V;IPFV;3;PST	mi³-dsiog¹²	mi³-dsiog¹²
nio²	V;IPFV;3;PST	mi³-nio²	mi³-nio²²
ɁløaɁ¹²	V;IPFV;3;PST	mi³-ɁløaɁ¹²	mi³-ɁløaɁ¹²
Ɂiá¹²	V;IPFV;3;PST	mi³-Ɂiá¹²	mi³-Ɂiá¹²
chiínɁ²	V;IPFV;3;PST	mi³-chiínɁ²	mi³-chiínɁ²
ɁniɁ¹²	V;IPFV;3;PST	mi³-ɁniɁ¹²	mi³-ɁniɁ¹²
dsúgɁ¹²	V;IPFV;3;PST	mi³-dsúgɁ¹²	mi³-dsúgɁ¹²
mi²+dsiúg²	V;IPFV;3;PST	mi³-mi²+dsiúg²	mi³-mi²+dsiúg
hnḗ¹²	V;IPFV;3;PST	mi³-hnḗ¹²	mi³-hnḗ¹²
u²+nio¹³	V;IPFV;3;PST	mi³-u²+nio¹³	mi³-u²+nio¹
laɁ¹²	V;IPFV;3;PST	mi³-laɁ¹²	mi³-laɁ¹²
øg¹²	V;IPFV;3;PST	mi³-øg¹²	mi³-øg¹²³
ɁǿɁ¹²	V;IPFV;3;PST	mi³-ɁǿɁ¹²	mi³-ɁǿɁ¹²
hngio¹²	V;IPFV;3;PST	mi³-hngio¹²	mi³-hngio¹²
mi²+Ɂan¹³	V;IPFV;3;PST	mi³-mi²+Ɂan¹³	mi³-mi²+Ɂan¹
siiɁ²	V;IPFV;3;PST	mi³-siiɁ²	mi³-siiɁ²
kuú²	V;IPFV;3;PST	mi³-kuú²	mi³-kuú²¹
iéiɁ¹²	V;IPFV;3;PST	mi³-iéiɁ¹²	mi³-iéiɁ¹²
hagɁ²	V;IPFV;3;PST	mi³-hagɁ²	mi³-hagɁ²
kon¹²	V;IPFV;3;PST	mi³-kon¹²	mi³-kon¹²
mi²+hlēnɁ¹	V;IPFV;3;PST	mi³-mi²+hlēnɁ¹	mi³-mi²+hlēnɁ
tei¹²	V;IPFV;3;PST	mi³-tei¹²	mi³-tei¹²
mi²+hniang¹ dsǿa¹²	V;IPFV;3;PST	mi³-mi²+hniang¹	mi³-mi²+hniang¹¹((
huánɁ¹²	V;IPFV;3;PST	mi³-huánɁ¹²	mi³-huánɁ¹²
ɁuanɁ¹²	V;IPFV;3;PST	mi³-ɁuanɁ¹²	mi³-ɁuanɁ¹²
kǿg²	V;IPFV;3;PST	mi³-kǿg²	mi³-kǿg²¹
hágɁ¹²	V;IPFV;3;PST	mi³-hágɁ¹²	mi³-hágɁ¹²
Ɂlǿg²	V;IPFV;3;PST	mi³-Ɂlǿg²	mi³-Ɂlǿg²
uøin²	V;IPFV;3;PST	mi³-uøin²	mi³-uøin²
hínɁ¹²	V;IPFV;3;PST	mi³-hínɁ¹²	mi³-hínɁ¹²
kánɁ²	V;IPFV;3;PST	mi³-kánɁ²	mi³-kánɁ²
ti²+kiín¹	V;IPFV;3;PST	mi³-ti²+kiín¹	mi³-ti²+kiín
ɁéɁ¹²	V;IPFV;3;PST	mi³-ɁéɁ¹²	mi³-ɁéɁ¹²
gḗɁ²	V;IPFV;3;PST	mi³-gḗɁ²	mi³-gḗɁ²³
ning²	V;IPFV;3;PST	mi³-ning²	mi³-ning²
kuúɁ²	V;IPFV;3;PST	mi³-kuúɁ²	mi³-kuúɁ²
høg²	V;IPFV;3;PST	mi³-høg²	mi³-høg²¹
Ɂei¹²	V;IPFV;3;PST	mi³-Ɂei¹²	mi³-Ɂei¹²
nung²	V;IPFV;3;PST	mi³-nung²	mi³-nung²
kḗn²	V;IPFV;3;PST	mi³-kḗn²	mi³-kḗn²¹
nio¹²	V;IPFV;3;PST	mi³-nio¹²	mi³-nio¹²
hní²	V;IPFV;3;PST	mi³-hní²	mi³-hní²²
u²+lei²	V;IPFV;3;PST	mi³-u²+lei²	mi³-u²+lei²
kángɁ¹²	V;IPFV;3;PST	mi³-kángɁ¹²	mi³-kángɁ¹²
hnái¹²	V;IPFV;3;PST	mi³-hnái¹²	mi³-hnái¹²
hniuɁ²	V;IPFV;3;PST	mi³-hniuɁ²	mi³-hniuɁ²
há¹²	V;IPFV;3;PST	mi³-há¹²	mi³-há¹²¹
ton²	V;IPFV;3;PST	mi³-ton²	mi³-ton²¹
héin²	V;IPFV;3;PST	mi³-héin²	mi³-héin²
iaɁ¹²	V;IPFV;3;PST	mi³-iaɁ¹²	mi³-iaɁ¹²
dsǿgɁ¹²	V;IPFV;3;PST	mi³-dsǿgɁ¹²	mi³-dsǿgɁ¹²
táiɁ¹²	V;IPFV;3;PST	mi³-táiɁ¹²	mi³-táiɁ¹²
chiág¹²	V;IPFV;3;PST	mi³-chiág¹²	mi³-chiág¹²
ha²+lig²	V;IPFV;3;PST	mi³-ha²+lig²	mi³-ha²+lig
ngo²	V;IPFV;3;PST	mi³-ngo²	mi³-ngo²²
niu¹²	V;IPFV;3;PST	mi³-niu¹²	mi³-niu¹²
dséi¹²	V;IPFV;3;PST	mi³-dséi¹²	mi³-dséi¹²
tiúɁ¹	V;IPFV;3;PST	mi³-tiúɁ¹	mi³-tiúɁ¹
køg²	V;IPFV;3;PST	mi³-køg²	mi³-køg²¹
hein¹²	V;IPFV;3;PST	mi³-hein¹²	mi³-hein¹²
Ɂa¹²	V;IPFV;3;PST	mi³-Ɂa¹²	mi³-Ɂa¹²²
lǿ²	V;IPFV;3;PST	mi³-lǿ²	mi³-lǿ²n
dsiágɁ¹²	V;IPFV;3;PST	mi³-dsiágɁ¹²	mi³-dsiágɁ¹
gug¹²	V;IPFV;3;PST	mi³-gug¹²	mi³-gug¹²
hnøa¹²	V;IPFV;3;PST	mi³-hnøa¹²	mi³-hnøa¹²
hug²	V;IPFV;3;PST	mi³-hug²	mi³-hug²¹
ɁmoɁ¹²	V;IPFV;3;PST	mi³-ɁmoɁ²	mi³-ɁmoɁ¹²
rǿng²	V;IPFV;3;PST	mi³-rǿng²	mi³-rǿng²
tsénɁ¹²	V;IPFV;3;PST	mi³-tsénɁ¹²	mi³-tsénɁ¹²
lø²+liugɁ³	V;IPFV;3;PST	mi³-lø²+liugɁ³	mi³-lø²+liugɁ
dsen¹²	V;IPFV;3;PST	mi³-dsen¹²	mi³-dsen¹²
huøi²	V;IPFV;3;PST	mi³-huøi²	mi³-huøi²
Ɂuán²	V;IPFV;3;PST	mi³-Ɂuán²	mi³-Ɂuán²
henɁ²	V;IPFV;3;PST	mi³-henɁ²	mi³-henɁ²
niɁ³	V;IPFV;3;PST	mi³-niɁ³	mi³-niɁ³²
siánɁ²	V;IPFV;3;PST	mi³-siánɁ²	mi³-siánɁ²
niáng¹²	V;IPFV;3;PST	mi³-niáng¹²	mi³-niáng¹²
kǿn²	V;IPFV;3;PST	mi³-kǿn²	mi³-kǿn²¹
dsø²+lé²	V;IPFV;3;PST	mi³-dsø²+lé²	mi³-dsø²+lé
hløa¹²	V;IPFV;3;PST	mi³-hløa¹²	mi³-hløa¹²
kø²+káng¹²	V;IPFV;SG;1;PST	mi³-kø²+kang¹²	mi³-kø²+kang
guiágɁ¹²	V;IPFV;SG;1;PST	mi³-guiagɁ¹²	mi³-guiagɁ¹
ɁnóɁ¹² dsí²	V;IPFV;SG;1;PST	mi³-ɁnoɁ¹²	mi³-ɁnoɁ¹²o³³
dsánɁ¹²	V;IPFV;SG;1;PST	mi³-dsanɁ¹²	mi³-dsanɁ¹²
Ɂuø¹²	V;IPFV;SG;1;PST	mi³-Ɂuø³	mi³-Ɂuø¹²
guión²	V;IPFV;SG;1;PST	mi³-guion³	mi³-guion³
lǿɁ²	V;IPFV;SG;1;PST	mi³-løi²	mi³-løɁ¹²
tií²	V;IPFV;SG;1;PST	mi³-tii¹²	mi³-tii¹²
guiénɁ²	V;IPFV;SG;1;PST	mi³-guienɁ¹²	mi³-guienɁ¹
héinɁ¹²	V;IPFV;SG;1;PST	mi³-heinɁ³	mi³-heinɁ¹²
mi²+kionɁ¹	V;IPFV;SG;1;PST	mi³-mi²+kionɁ¹³	mi³-mi²+kion
hénɁ²	V;IPFV;SG;1;PST	mi³-henɁ³	mi³-henɁ¹
hǿɁ¹²	V;IPFV;SG;1;PST	mi³-tsøɁ¹²	mi³-høɁ¹²
chi²+dsán²	V;IPFV;SG;1;PST	mi³-chi²+dsan²	mi³-chi²+dsa
mi²+dsøg¹²	V;IPFV;SG;1;PST	mi³-mi²+dsøg¹³	mi³-mi²+dsøg
guieɁ¹²	V;IPFV;SG;1;PST	mi³-guieɁ¹²	mi³-guieɁ¹²
mi²+chian¹²	V;IPFV;SG;1;PST	mi³-mi²+chian³	mi³-mi²+chian
guiúg²	V;IPFV;SG;1;PST	mi³-guiug³	mi³-guiug¹
Ɂon¹²	V;IPFV;SG;1;PST	mi³-Ɂon¹²	mi³-Ɂon¹²
niá¹²	V;IPFV;SG;1;PST	mi³-nia¹²	mi³-nia¹²
tangɁ²	V;IPFV;SG;1;PST	mi³-tangɁ¹²	mi³-tangɁ¹
Ɂan¹²	V;IPFV;SG;1;PST	mi³-Ɂan¹²	mi³-Ɂan¹²
dsian¹²	V;IPFV;SG;1;PST	mi³-dsian¹²	mi³-dsian¹²
dság¹²	V;IPFV;SG;1;PST	mi³-dsag¹²	mi³-dsag¹²
hmóngɁ¹²	V;IPFV;SG;1;PST	mi³-hmongɁ¹²	mi³-hmongɁ¹
chi²+dsí²	V;IPFV;SG;1;PST	mi³-chi²+dsi³	mi³-chi²+dsi
tsanɁ¹²	V;IPFV;SG;1;PST	mi³-huanɁ³	mi³-tsanɁ¹²
tánɁ¹²	V;IPFV;SG;1;PST	mi³-tanɁ¹²	mi³-tanɁ¹²
kuøin¹²	V;IPFV;SG;1;PST	mi³-kuøin²	mi³-kuøin¹²
gógɁ¹²	V;IPFV;SG;1;PST	mi³-gogɁ¹²	mi³-gogɁ¹²
tsø²+nióɁ¹²	V;IPFV;SG;1;PST	mi³-tsø²+nioɁ¹	mi³-tsø²+nioɁ
mi²+hénɁ²	V;IPFV;SG;1;PST	mi³-mi²+henɁ³	mi³-mi²+henɁ
ti²+líɁ¹	V;IPFV;SG;1;PST	mi³-ti²+lei2¹	mi³-ti²+lei
hánɁ¹²	V;IPFV;SG;1;PST	mi³-hanɁ¹²	mi³-hanɁ¹²
mi²+kiíngɁ²	V;IPFV;SG;1;PST	mi³-mi²+kiingɁ³	mi³-mi²+kiing
ɁúgɁ²	V;IPFV;SG;1;PST	mi³-ɁogɁ³	mi³-ɁugɁ³
chio¹²	V;IPFV;SG;1;PST	mi³-chio¹²	mi³-chio¹²
hinɁ³	V;IPFV;SG;1;PST	mi³-hinɁ³	mi³-hinɁ³
tian¹²	V;IPFV;SG;1;PST	mi³-tian¹³	mi³-tian¹²
mi²+hmḗ²	V;IPFV;SG;1;PST	mi³-mi²+hmē³	mi³-mi²+hmē
ngē¹²	V;IPFV;SG;1;PST	mi³-ngē¹³	mi³-ngē¹²
lanɁ¹²	V;IPFV;SG;1;PST	mi³-lanɁ¹²	mi³-lanɁ¹²
ngái¹²	V;IPFV;SG;1;PST	mi³-ngai³	mi³-ngai¹²
tsø²+kuenɁ¹²	V;IPFV;SG;1;PST	mi³-tsø²+kuenɁ¹²	mi³-tsø²+kuenɁ
Ɂøa¹²	V;IPFV;SG;1;PST	mi³-Ɂøa¹²	mi³-Ɂøa¹²
hngiáɁ²	V;IPFV;SG;1;PST	mi³-hngiaɁ¹²	mi³-hngiaɁ¹
ngioɁ¹²	V;IPFV;SG;1;PST	mi³-ngioɁ²	mi³-ngioɁ²²
ngøa¹²	V;IPFV;SG;1;PST	mi³-ngøa¹²	mi³-ngøa¹²
ɁlianɁ²	V;IPFV;SG;1;PST	mi³-ɁlianɁ²	mi³-ɁlianɁ³
hngióɁ¹²	V;IPFV;SG;1;PST	mi³-hngioɁ¹³	mi³-hngioɁ¹
se¹²	V;IPFV;SG;1;PST	mi³-se²	mi³-se¹²³
tsǿɁ¹²	V;IPFV;SG;1;PST	mi³-tsøɁ¹²	mi³-tsøɁ¹²
rónɁ¹²	V;IPFV;SG;1;PST	mi³-rang¹²	mi³-ronɁ¹²
ha²+Ɂan³	V;IPFV;SG;1;PST	mi³-ha²+Ɂan³	mi³-ha²+Ɂan
kúgɁ¹²	V;IPFV;SG;1;PST	mi³-kugɁ¹²	mi³-kugɁ¹²
huúɁ¹²	V;IPFV;SG;1;PST	mi³-huuɁ³	mi³-huuɁ¹²
kágɁ¹²	V;IPFV;SG;1;PST	mi³-kagɁ³	mi³-kagɁ¹²
hḗnɁ²	V;IPFV;SG;1;PST	mi³-hēnɁ¹³	mi³-hēnɁ¹
mi²+hnia¹²	V;IPFV;SG;1;PST	mi³-mi²+hnia¹³	mi³-mi²+hnia
hian¹²	V;IPFV;SG;1;PST	mi³-han²	mi³-hian¹²
ku² hmo¹²	V;IPFV;SG;1;PST	mi³-ku¹²	mi³-ku¹²¹¹¹³
kión²	V;IPFV;SG;1;PST	mi³-kion³	mi³-kion¹
téiɁ¹²	V;IPFV;SG;1;PST	mi³-teiɁ¹²	mi³-teiɁ¹²
lóɁ¹²	V;IPFV;SG;1;PST	mi³-loɁ¹²	mi³-loɁ¹²
tsog¹²	V;IPFV;SG;1;PST	mi³-tsog¹³	mi³-tsog¹²
hnḗɁ²	V;IPFV;SG;1;PST	mi³-hnēɁ³	mi³-hnēɁ³
ɁóɁ²	V;IPFV;SG;1;PST	mi³-ɁoɁ¹²	mi³-ɁoɁ¹²
ngē²	V;IPFV;SG;1;PST	mi³-ngē³	mi³-ngē¹²
mi²+ɁḗɁ²	V;IPFV;SG;1;PST	mi³-mi²+ɁēɁ³	mi³-mi²+ɁēɁ
tø²+ɁénɁ¹²	V;IPFV;SG;1;PST	mi³-tø²+ɁenɁ³	mi³-tø²+ɁenɁ
uénɁ²	V;IPFV;SG;1;PST	mi³-uenɁ²	mi³-uenɁ²
rón²	V;IPFV;SG;1;PST	mi³-ron²	mi³-ron²²
Ɂo¹²	V;IPFV;SG;1;PST	mi³-Ɂo¹²	mi³-Ɂo¹²²
hǿɁ²	V;IPFV;SG;1;PST	mi³-høɁ¹²	mi³-høɁ¹²
hnǿ²	V;IPFV;SG;1;PST	mi³-hnø¹²	mi³-hnø¹¹
tai²	V;IPFV;SG;1;PST	mi³-tai³	mi³-tai¹²
mi²+tan¹³	V;IPFV;SG;1;PST	mi³-mi²+tan¹³	mi³-mi²+tan¹
ɁuǿɁ¹²	V;IPFV;SG;1;PST	mi³-ɁuøɁ¹³	mi³-ɁuøɁ¹²
kán²	V;IPFV;SG;1;PST	mi³-kan¹²	mi³-kan¹²
háinɁ¹²	V;IPFV;SG;1;PST	mi³-hainɁ¹²	mi³-hainɁ¹²
dsø²+huen¹³	V;IPFV;SG;1;PST	mi³-dsø²+huen¹³	mi³-dsø²+huen
lag²	V;IPFV;SG;1;PST	mi³-lag¹²	mi³-lag¹²
kiúgɁ²	V;IPFV;SG;1;PST	mi³-kiugɁ³	mi³-kiugɁ³
huú²	V;IPFV;SG;1;PST	mi³-huø¹²	mi³-huu²²
mi²+Ɂnio¹	V;IPFV;SG;1;PST	mi³-mi²+Ɂnio¹	mi³-mi²+Ɂnio
bán²	V;IPFV;SG;1;PST	mi³-ban¹²	mi³-ban¹²
kiuɁ¹²	V;IPFV;SG;1;PST	mi³-kiuɁ¹²	mi³-kiuɁ¹²
guøn¹²	V;IPFV;SG;1;PST	mi³-guøn¹²	mi³-guøn¹²
mi²+gug¹	V;IPFV;SG;1;PST	mi³-mi²+gug¹	mi³-mi²+gug
len¹²	V;IPFV;SG;1;PST	mi³-len¹²	mi³-len¹²
rǿnɁ¹²	V;IPFV;SG;1;PST	mi³-rønɁ³	mi³-rønɁ¹²
lán¹²	V;IPFV;SG;1;PST	mi³-lan¹²	mi³-lan¹²
niá²	V;IPFV;SG;1;PST	mi³-na¹²	mi³-nia¹²
Ɂno¹²	V;IPFV;SG;1;PST	mi³-Ɂno¹²	mi³-Ɂno¹²
mi²+kien¹²	V;IPFV;SG;1;PST	mi³-mi²+kien¹³	mi³-mi²+kien
chióɁ¹²	V;IPFV;SG;1;PST	mi³-chioɁ³	mi³-chioɁ³²
ngiéɁ¹²	V;IPFV;SG;1;PST	mi³-ngieɁ³	mi³-ngieɁ¹²
siúg²	V;IPFV;SG;1;PST	mi³-siog³	mi³-siug²
huánɁ²	V;IPFV;SG;1;PST	mi³-huanɁ¹²	mi³-huanɁ¹
dsiag¹²	V;IPFV;SG;1;PST	mi³-dsiag¹²	mi³-dsiag¹²
teng¹²	V;IPFV;SG;1;PST	mi³-tøng¹²	mi³-teng¹²
mi²+kon¹²	V;IPFV;SG;1;PST	mi³-mi²+kon³	mi³-mi²+kon³
hanɁ¹² dsǿa¹²	V;IPFV;SG;1;PST	mi³-hanɁ¹²	mi³-hanɁ¹²u²³¹
méɁ²	V;IPFV;SG;1;PST	mi³-meɁ¹²	mi³-meɁ¹²
ngié²	V;IPFV;SG;1;PST	mi³-ngie²	mi³-ngie²
tsogɁ² hmøi²	V;IPFV;SG;1;PST	mi³-tsogɁ²	mi³-tsogɁ²²²¹¹
ɁnáiɁ¹²	V;IPFV;SG;1;PST	mi³-ɁnaiɁ¹²	mi³-ɁnaiɁ¹²
hnio³	V;IPFV;SG;1;PST	mi³-hnio³	mi³-hnio³
Ɂngio¹²	V;IPFV;SG;1;PST	mi³-Ɂngio¹²	mi³-Ɂngio¹²
ténɁ¹²	V;IPFV;SG;1;PST	mi³-tenɁ³	mi³-tenɁ¹²
guǿn¹²	V;IPFV;SG;1;PST	mi³-guøn¹²	mi³-guøn¹²
tán¹²	V;IPFV;SG;1;PST	mi³-tan¹²	mi³-tan¹²
tson²	V;IPFV;SG;1;PST	mi³-tson²	mi³-tson²
Ɂio¹²	V;IPFV;SG;1;PST	mi³-Ɂio¹²	mi³-Ɂio¹²
hen¹²	V;IPFV;SG;1;PST	mi³-hen¹²	mi³-hen¹²
hián²	V;IPFV;SG;1;PST	mi³-hian¹²	mi³-hian¹
huǿin¹²	V;IPFV;SG;1;PST	mi³-huøin¹²	mi³-huøin¹²
tsón¹²	V;IPFV;SG;1;PST	mi³-tson¹²	mi³-tson¹²
kii²+túg²	V;IPFV;SG;1;PST	mi³-kii²+tog³	mi³-kii²+tog
kii²+tág¹²	V;IPFV;SG;1;PST	mi³-kii²+tag¹²	mi³-kii²+tag
dsoɁ²	V;IPFV;SG;1;PST	mi³-dsoɁ²	mi³-dsoɁ²
køn¹²	V;IPFV;SG;1;PST	mi³-køn¹²	mi³-køn¹²
tsog²	V;IPFV;SG;1;PST	mi³-tsog²	mi³-tsog²
mi²+tsḗn¹	V;IPFV;SG;1;PST	mi³-mi²+tsēn¹³	mi³-mi²+tsēn
tsǿaɁ¹²	V;IPFV;SG;1;PST	mi³-huøɁ¹²	mi³-tsøaɁ¹²
hne¹²	V;IPFV;SG;1;PST	mi³-hnøa¹²	mi³-hne¹²
ɁioɁ¹²	V;IPFV;SG;1;PST	mi³-Ɂiag¹²	mi³-ɁioɁ¹²
tsǿng²	V;IPFV;SG;1;PST	mi³-tsøng¹²	mi³-tsøng¹
hág¹²	V;IPFV;SG;1;PST	mi³-hag¹³	mi³-hag¹²
hmóɁ¹²	V;IPFV;SG;1;PST	mi³-hmoɁ³	mi³-hmoɁ¹²
hngie¹²	V;IPFV;SG;1;PST	mi³-han³	mi³-han³²³u
nēɁ¹²	V;IPFV;SG;1;PST	mi³-nēɁ¹²	mi³-nēɁ¹²
húɁ²	V;IPFV;SG;1;PST	mi³-huɁ²	mi³-huɁ²²
mi²+dsiog¹	V;IPFV;SG;1;PST	mi³-mi²+dsiog¹	mi³-mi²+dsio
Ɂnia¹²	V;IPFV;SG;1;PST	mi³-Ɂnia¹³	mi³-Ɂnia¹²
dsúgɁ²	V;IPFV;SG;1;PST	mi³-dsugɁ³	mi³-dsugɁ¹
dsiánɁ¹²	V;IPFV;SG;1;PST	mi³-dsianɁ¹²	mi³-dsianɁ¹
kieg²	V;IPFV;SG;1;PST	mi³-ko¹²	mi³-kieg¹
mi²+tan¹²	V;IPFV;SG;1;PST	mi³-mi²+tan³	mi³-mi²+tan³
køin²	V;IPFV;SG;1;PST	mi³-køin¹²	mi³-køin²
chiáng¹²	V;IPFV;SG;1;PST	mi³-chiang¹²	mi³-chiang¹
ɁēnɁ¹²	V;IPFV;SG;1;PST	mi³-ɁēnɁ²	mi³-ɁēnɁ²²
Ɂlúg²	V;IPFV;SG;1;PST	mi³-Ɂlug²	mi³-Ɂlug²
møa¹²	V;IPFV;SG;1;PST	mi³-møa¹²	mi³-møa¹²
gǿaɁ¹²	V;IPFV;SG;1;PST	mi³-gøaɁ¹²	mi³-gøaɁ¹²
guen²	V;IPFV;SG;1;PST	mi³-guen²	mi³-guen¹
tug	V;IPFV;SG;1;PST	mi³-tug¹²	mi³-tug¹
hngēɁ¹²	V;IPFV;SG;1;PST	mi³-hngēɁ²	mi³-hngēɁ²²
dsie¹²	V;IPFV;SG;1;PST	mi³-dsie¹²	mi³-dsie¹²
tsénɁ²	V;IPFV;SG;1;PST	mi³-tsēnɁ³	mi³-tsenɁ³
chiunɁ¹²	V;IPFV;SG;1;PST	mi³-chiunɁ³	mi³-chiunɁ²
tióɁ¹²	V;IPFV;SG;1;PST	mi³-tiag¹²	mi³-tioɁ¹²
tø²+húg³	V;IPFV;SG;1;PST	mi³-tø²+hug³	mi³-tø²+hug
tsēn¹²	V;IPFV;SG;1;PST	mi³-tsēn¹²	mi³-tsēn¹²
chiogɁ¹²	V;IPFV;SG;1;PST	mi³-chiogɁ¹²	mi³-chiogɁ¹
chi²+méɁ²	V;IPFV;SG;1;PST	mi³-chi²+meɁ¹²	mi³-chi²+meɁ
chi²+lánɁ²	V;IPFV;SG;1;PST	mi³-chi²+lanɁ¹²	mi³-chi²+lan
Ɂén²	V;IPFV;SG;1;PST	mi³-Ɂen¹²	mi³-Ɂen¹²
hánɁ²	V;IPFV;SG;1;PST	mi³-hanɁ¹²	mi³-hanɁ¹
mi²+kuuɁ¹²	V;IPFV;SG;1;PST	mi³-mi²+kuuɁ¹³	mi³-mi²+kuuɁ
mi²+hlíɁ²	V;IPFV;SG;1;PST	mi³-mi²+hliɁ³	mi³-mi²+hliɁ
búɁ²	V;IPFV;SG;1;PST	mi³-buɁ¹²	mi³-buɁ¹²
køɁ³ (hmai³)	V;IPFV;SG;1;PST	mi³-kai³	mi³-kai³¹²³¹²¹
Ɂiei¹²	V;IPFV;SG;1;PST	mi³-Ɂiei¹²	mi³-Ɂiei¹²
niuɁ³	V;IPFV;SG;1;PST	mi³-niuɁ³	mi³-niuɁ³
hngiángɁ¹²	V;IPFV;SG;1;PST	mi³-hngiangɁ³	mi³-hngiangɁ
kién¹²	V;IPFV;SG;1;PST	mi³-kien¹³	mi³-kien¹³
hḗn²	V;IPFV;SG;1;PST	mi³-hēn¹²	mi³-hēn²²
mi²+hngió¹	V;IPFV;SG;1;PST	mi³-mi²+hngio¹³	mi³-mi²+hngi
chión²	V;IPFV;SG;1;PST	mi³-chion³	mi³-chion³
guianɁ¹²	V;IPFV;SG;1;PST	mi³-guianɁ²	mi³-guianɁ¹
hmḗɁ²	V;IPFV;SG;1;PST	mi³-hmēɁ³	mi³-hmēɁ³
Ɂiog¹²	V;IPFV;SG;1;PST	mi³-Ɂog¹²	mi³-Ɂiog¹²
dsiég¹²	V;IPFV;SG;1;PST	mi³-dsieg¹²	mi³-dsieg¹²
tǿɁ²	V;IPFV;SG;1;PST	mi³-tøa¹²	mi³-tøɁ¹²
ngøɁ¹²	V;IPFV;SG;1;PST	mi³-ngøɁ³	mi³-ngøɁ¹²
huúɁ²	V;IPFV;SG;1;PST	mi³-huuɁ¹²	mi³-huuɁ¹
mi²+gan¹²	V;IPFV;SG;1;PST	mi³-mi²+gan¹³	mi³-mi²+gan¹
lieɁ¹²	V;IPFV;SG;1;PST	mi³-laɁ³	mi³-lieɁ¹²
ti²+dsǿ²	V;IPFV;SG;1;PST	mi³-ti²+dsø³	mi³-ti²+dsø
chiag¹²	V;IPFV;SG;1;PST	mi³-chiag¹²	mi³-chiag¹²
chi²+hné¹	V;IPFV;SG;1;PST	mi³-chi²+hne³	mi³-chi²+hne
guen¹²	V;IPFV;SG;1;PST	mi³-guen³	mi³-guen¹²
mi²+hǿ²	V;IPFV;SG;1;PST	mi³-mi²+hø³	mi³-mi²+hø³
hmáɁ² (dsǿa¹²)	V;IPFV;SG;1;PST	mi³-hmaɁ¹³	mi³-hmaɁ¹³²²¹¹²
tónɁ² (huu¹²)	V;IPFV;SG;1;PST	mi³-tonɁ¹²	mi³-tonɁ¹²²²¹²
tanɁ²	V;IPFV;SG;1;PST	mi³-tanɁ²	mi³-tanɁ¹
hogɁ¹²	V;IPFV;SG;1;PST	mi³-hogɁ¹²	mi³-hogɁ¹²
mi²+kánɁ²	V;IPFV;SG;1;PST	mi³-mi²+kanɁ³	mi³-mi²+kanɁ
Ɂuan¹²	V;IPFV;SG;1;PST	mi³-Ɂuan¹³	mi³-Ɂuan¹³
li²	V;IPFV;SG;1;PST	mi³-li¹²	mi³-li¹²
Ɂúg²	V;IPFV;SG;1;PST	mi³-Ɂug¹²	mi³-Ɂug¹²
kēnɁ¹²	V;IPFV;SG;1;PST	mi³-kēnɁ²	mi³-kēnɁ¹²
tsiɁ¹²	V;IPFV;SG;1;PST	mi³-tsøɁ¹²	mi³-tsiɁ¹²
kiéɁ¹²	V;IPFV;SG;1;PST	mi³-kieɁ³	mi³-kieɁ¹³
hlái²	V;IPFV;SG;1;PST	mi³-hlai¹²	mi³-hlai¹
ɁnióɁ¹²	V;IPFV;SG;1;PST	mi³-ɁnioɁ¹²	mi³-ɁnioɁ³²
ngiú²	V;IPFV;SG;1;PST	mi³-ngiu²	mi³-ngiu²
tag¹²	V;IPFV;SG;1;PST	mi³-tag¹²	mi³-tag¹²
ɁiánɁ²	V;IPFV;SG;1;PST	mi³-ɁianɁ¹²	mi³-ɁianɁ¹
mi²+Ɂai¹	V;IPFV;SG;1;PST	mi³-mi²+Ɂai¹	mi³-mi²+Ɂai
tsí¹²	V;IPFV;SG;1;PST	mi³-tsi¹²	mi³-tsi¹²
kiog¹²	V;IPFV;SG;1;PST	mi³-kog²	mi³-kiog¹²
hlán²	V;IPFV;SG;1;PST	mi³-hlan³	mi³-hlan¹
u¹+lén²	V;IPFV;SG;1;PST	mi³-u²+len¹³	mi³-u²+len¹
tsen¹²	V;IPFV;SG;1;PST	mi³-tsēn³	mi³-tsen¹²
dsan²	V;IPFV;SG;1;PST	mi³-dsan²	mi³-dsan²
ɁónɁ²	V;IPFV;SG;1;PST	mi³-ɁonɁ³	mi³-ɁonɁ¹
hliúg² (lag³ dsi³)	V;IPFV;SG;1;PST	mi³-hliug¹²	mi³-hliug¹²¹³²³((
hmáɁ² (ta³)	V;IPFV;SG;1;PST	mi³-hmaɁ¹³	mi³-hmaɁ¹³u³³
dsán²	V;IPFV;SG;1;PST	mi³-dsan¹²	mi³-dsan¹
lø²+liúɁ²	V;IPFV;SG;1;PST	mi³-lø²+liuɁ¹²	mi³-lø²+liuɁ
dsǿɁ²	V;IPFV;SG;1;PST	mi³-dsøɁ¹²	mi³-dsøɁ¹
ha¹²	V;IPFV;SG;1;PST	mi³-ha¹³	mi³-ha¹²¹
guian¹²	V;IPFV;SG;1;PST	mi³-guian¹³	mi³-guian¹²
ti²+li¹	V;IPFV;SG;1;PST	mi³-ti²+li³	mi³-ti²+li³
mi²+ngḗɁ¹	V;IPFV;SG;1;PST	mi³-mi²+ngēɁ³	mi³-mi²+ngēɁ
Ɂien²	V;IPFV;SG;1;PST	mi³-Ɂien²	mi³-Ɂien²
guiúnɁ¹²	V;IPFV;SG;1;PST	mi³-guionɁ¹³	mi³-guiunɁ¹
mi²+kuen¹²	V;IPFV;SG;1;PST	mi³-mi²+kuen¹³	mi³-mi²+kuen
hliánɁ²	V;IPFV;SG;1;PST	mi³-hlianɁ¹³	mi³-hlianɁ¹
mi²+gǿg¹	V;IPFV;SG;1;PST	mi³-mi²+gøg¹	mi³-mi²+gøg
kanɁ¹²	V;IPFV;SG;1;PST	mi³-kanɁ¹²	mi³-kanɁ¹²
Ɂmǿi²	V;IPFV;SG;1;PST	mi³-Ɂmai¹²	mi³-Ɂmai¹
chi²+ngió²	V;IPFV;SG;1;PST	mi³-chi²+ngio³	mi³-chi²+ngi
hnó²	V;IPFV;SG;1;PST	mi³-hno³	mi³-hno¹²
Ɂnē¹²	V;IPFV;SG;1;PST	mi³-Ɂnē¹²	mi³-Ɂnē¹²
Ɂngieng¹²	V;IPFV;SG;1;PST	mi³-Ɂngieng¹²	mi³-Ɂngieng¹
hné¹²	V;IPFV;SG;1;PST	mi³-hnē³	mi³-hne¹²
gǿi¹²	V;IPFV;SG;1;PST	mi³-gøi¹²	mi³-gøi¹²
chiog¹²	V;IPFV;SG;1;PST	mi³-chiog²	mi³-chiog¹²
húgɁ²	V;IPFV;SG;1;PST	mi³-hogɁ¹²	mi³-hugɁ¹
kiáɁ²	V;IPFV;SG;1;PST	mi³-kiaɁ¹³	mi³-kiaɁ¹
mi²+rø¹²	V;IPFV;SG;1;PST	mi³-mi²+rø³	mi³-mi²+rø³
tiú²	V;IPFV;SG;1;PST	mi³-tiu¹²	mi³-tiu¹²
dsogɁ¹²	V;IPFV;SG;1;PST	mi³-dsogɁ¹²	mi³-dsogɁ¹²
kií¹²	V;IPFV;SG;1;PST	mi³-kø¹²	mi³-kii¹²
kian¹²	V;IPFV;SG;1;PST	mi³-kian¹³	mi³-kian¹³
mi²+hínɁ²	V;IPFV;SG;1;PST	mi³-mi²+hinɁ³	mi³-mi²+hinɁ
Ɂngiéng¹²	V;IPFV;SG;1;PST	mi³-Ɂngieng¹²	mi³-Ɂngieng¹
ɁnáɁ¹²	V;IPFV;SG;1;PST	mi³-ɁnaɁ¹²	mi³-ɁnaɁ¹²
ɁliuɁ¹²	V;IPFV;SG;1;PST	mi³-ɁliuɁ¹²	mi³-ɁliuɁ¹²
tso¹²	V;IPFV;SG;1;PST	mi³-ho¹²	mi³-tso¹²
siég²	V;IPFV;SG;1;PST	mi³-sieg²	mi³-sieg²
sianɁ¹²	V;IPFV;SG;1;PST	mi³-sianɁ¹³	mi³-sianɁ¹²
nió²	V;IPFV;SG;1;PST	mi³-nio¹²	mi³-nio¹²
kien¹²	V;IPFV;SG;1;PST	mi³-kien¹³	mi³-kien¹²
búɁ¹²	V;IPFV;SG;1;PST	mi³-buɁ¹²	mi³-buɁ¹²
Ɂuan²	V;IPFV;SG;1;PST	mi³-Ɂuan²	mi³-Ɂuan¹
mi²+hniang¹ ni³	V;IPFV;SG;1;PST	mi³-mi²+hniang³	mi³-mi²+hniang³
mi²+guionɁ¹	V;IPFV;SG;1;PST	mi³-mi²+guionɁ³	mi³-mi²+guion
tagɁ²	V;IPFV;SG;1;PST	mi³-tagɁ¹²	mi³-tagɁ¹
kúgɁ²	V;IPFV;SG;1;PST	mi³-kugɁ³	mi³-kugɁ¹
ɁngióɁ¹²	V;IPFV;SG;1;PST	mi³-ɁngioɁ²	mi³-ɁngioɁ¹
Ɂma¹²	V;IPFV;SG;1;PST	mi³-Ɂma¹²	mi³-Ɂma¹²
chiágɁ¹²	V;IPFV;SG;1;PST	mi³-chiagɁ¹²	mi³-chiagɁ¹
tø²+kanɁ¹³	V;IPFV;SG;1;PST	mi³-tø²+kanɁ¹³	mi³-tø²+kanɁ
hiégɁ¹²	V;IPFV;SG;1;PST	mi³-hiegɁ¹²	mi³-hiegɁ¹²
ngáɁ¹²	V;IPFV;SG;1;PST	mi³-ngaɁ¹²	mi³-ngaɁ¹²
mi²+Ɂliúg²	V;IPFV;SG;1;PST	mi³-mi²+Ɂliug³	mi³-mi²+Ɂliu
tanɁ¹² huu¹²	V;IPFV;SG;1;PST	mi³-tanɁ²	mi³-tanɁ²³o³³²
Ɂug¹²	V;IPFV;SG;1;PST	mi³-Ɂug¹³	mi³-Ɂug¹³
hái¹²	V;IPFV;SG;1;PST	mi³-hai¹²	mi³-hai¹²
hén²	V;IPFV;SG;1;PST	mi³-hen²	mi³-hen¹²
mi²+Ɂan¹²	V;IPFV;SG;1;PST	mi³-mi²+Ɂan¹³	mi³-mi²+Ɂan¹
dsēn¹²	V;IPFV;SG;1;PST	mi³-dsēn¹³	mi³-dsēn¹²
hngieng¹²	V;IPFV;SG;1;PST	mi³-hngieng³	mi³-hngieng³
tsai¹²	V;IPFV;SG;1;PST	mi³-tsai²	mi³-tsai¹²
pø²+hánɁ²	V;IPFV;SG;1;PST	mi³-pø²+hanɁ¹²	mi³-pø²+hanɁ
lá¹²	V;IPFV;SG;1;PST	mi³-la²	mi³-la¹²²
bí²	V;IPFV;SG;1;PST	mi³-bi¹²	mi³-bi¹²
Ɂø²+tsúgɁ²	V;IPFV;SG;1;PST	mi³-Ɂø²+tsogɁ²	mi³-Ɂø²+tsog
ɁaiɁ²	V;IPFV;SG;1;PST	mi³-ɁaiɁ¹²	mi³-ɁaiɁ¹
Ɂéi¹²	V;IPFV;SG;1;PST	mi³-Ɂei¹³	mi³-Ɂei¹²
mi²+kiín¹	V;IPFV;SG;1;PST	mi³-mi²+kiin³	mi³-mi²+kiin
tsøi¹²	V;IPFV;SG;1;PST	mi³-tsøi²	mi³-tsøi¹²
gúg²	V;IPFV;SG;1;PST	mi³-gug¹²	mi³-gug¹²
Ɂuǿi²	V;IPFV;SG;1;PST	mi³-Ɂuai¹²	mi³-Ɂuai¹
hnióɁ²	V;IPFV;SG;1;PST	mi³-hnioɁ²	mi³-hnioɁ³
tsenɁ¹²	V;IPFV;SG;1;PST	mi³-tsēnɁ²	mi³-tsenɁ¹²
guieng¹²	V;IPFV;SG;1;PST	mi³-guieng¹²	mi³-guieng¹
ɁǿnɁ²	V;IPFV;SG;1;PST	mi³-gøɁ¹²	mi³-ɁønɁ²
Ɂe¹²	V;IPFV;SG;1;PST	mi³-Ɂe¹²	mi³-Ɂe¹²¹
nang¹²	V;IPFV;SG;1;PST	mi³-nang¹²	mi³-nang¹²
kuénɁ²	V;IPFV;SG;1;PST	mi³-kuenɁ³	mi³-kuenɁ³
mi²+kiónɁ²	V;IPFV;SG;1;PST	mi³-mi²+kionɁ³	mi³-mi²+kion
kiagɁ¹²	V;IPFV;SG;1;PST	mi³-kiagɁ¹²	mi³-kiagɁ¹²
lio¹²	V;IPFV;SG;1;PST	mi³-lo¹²	mi³-loo¹²
tian¹	V;IPFV;SG;1;PST	mi³-tian¹	mi³-tian¹
guiugɁ²	V;IPFV;SG;1;PST	mi³-guiugɁ²	mi³-guiugɁ²
mi²+hní¹	V;IPFV;SG;1;PST	mi³-mi²+hni³	mi³-mi²+hni
hngióɁ²	V;IPFV;SG;1;PST	mi³-hngioɁ³	mi³-hngioɁ³
ɁenɁ¹²	V;IPFV;SG;1;PST	mi³-ɁenɁ¹³	mi³-ɁenɁ¹²
tsēnɁ¹²	V;IPFV;SG;1;PST	mi³-tsēnɁ¹²	mi³-tsēnɁ¹²
kang²	V;IPFV;SG;1;PST	mi³-kang¹²	mi³-kang¹
liúg²	V;IPFV;SG;1;PST	mi³-log³	mi³-liug²
ngǿi²	V;IPFV;SG;1;PST	mi³-ngai¹²	mi³-ngai¹
hḗɁ²	V;IPFV;SG;1;PST	mi³-hēɁ²	mi³-hēɁ²²
kø²+hinɁ¹²	V;IPFV;SG;1;PST	mi³-kø²+hinɁ³	mi³-kø²+hinɁ
guenɁ¹²	V;IPFV;SG;1;PST	mi³-guenɁ²	mi³-guenɁ¹²
hénɁ¹²	V;IPFV;SG;1;PST	mi³-henɁ¹²	mi³-henɁ¹²
Ɂen¹²	V;IPFV;SG;1;PST	mi³-Ɂen²	mi³-Ɂen¹²
ngie³	V;IPFV;SG;1;PST	mi³-ngie³	mi³-ngie³
ngieɁ¹³	V;IPFV;SG;1;PST	mi³-ngieɁ¹³	mi³-ngieɁ¹³
lióg¹²	V;IPFV;SG;1;PST	mi³-log¹²	mi³-loog¹²
kón²	V;IPFV;SG;1;PST	mi³-kon³	mi³-kon¹²
Ɂian²	V;IPFV;SG;1;PST	mi³-Ɂian²	mi³-Ɂian²
ɁéɁ²	V;IPFV;SG;1;PST	mi³-ɁeɁ²	mi³-ɁeɁ¹²
Ɂnai¹²	V;IPFV;SG;1;PST	mi³-Ɂnai¹²	mi³-Ɂnai¹²
hngió²	V;IPFV;SG;1;PST	mi³-hngio¹²	mi³-hngio¹
Ɂme¹²	V;IPFV;SG;1;PST	mi³-Ɂme²	mi³-Ɂme¹²
Ɂé²	V;IPFV;SG;1;PST	mi³-Ɂe²	mi³-Ɂe¹²
Ɂmóng¹²	V;IPFV;SG;1;PST	mi³-Ɂmong¹²	mi³-Ɂmong¹²
mi²+hu¹	V;IPFV;SG;1;PST	mi³-mi²+hu³	mi³-mi²+hu³
Ɂia¹²	V;IPFV;SG;1;PST	mi³-Ɂia¹²	mi³-Ɂia¹²
u¹+lian¹	V;IPFV;SG;1;PST	mi³-u²+lian¹	mi³-u²+lian
Ɂian¹²	V;IPFV;SG;1;PST	mi³-Ɂian¹²	mi³-Ɂian¹³
bø²+lḗnɁ²	V;IPFV;SG;1;PST	mi³-bø²+lēnɁ²	mi³-bø²+lēnɁ
tø²+dsḗn³	V;IPFV;SG;1;PST	mi³-tø²+dsēn³	mi³-tø²+dsēn
mi²+dsian¹²	V;IPFV;SG;1;PST	mi³-mi²+dsian¹³	mi³-mi²+dsian
kēn²	V;IPFV;SG;1;PST	mi³-kēn³	mi³-kēn²²
kiang¹²	V;IPFV;SG;1;PST	mi³-kiang¹³	mi³-kiang¹²
chiúg²	V;IPFV;SG;1;PST	mi³-chiug¹²	mi³-chiug¹
ɁánɁ²	V;IPFV;SG;1;PST	mi³-ɁanɁ¹²	mi³-ɁanɁ¹
ɁlanɁ¹²	V;IPFV;SG;1;PST	mi³-ɁlanɁ¹³	mi³-ɁlanɁ¹²
tiúg²	V;IPFV;SG;1;PST	mi³-tiug¹²	mi³-tiug²
guu²+dsḗn¹³	V;IPFV;SG;1;PST	mi³-guu²+dsēn¹³	mi³-guu²+dsēn
guiánɁ¹²	V;IPFV;SG;1;PST	mi³-guianɁ¹²	mi³-guianɁ¹
hniá¹²	V;IPFV;SG;1;PST	mi³-hnia¹²	mi³-hnia¹²
hlíɁ¹²	V;IPFV;SG;1;PST	mi³-hløɁ¹²	mi³-hliɁ¹²
Ɂí²	V;IPFV;SG;1;PST	mi³-Ɂu¹²	mi³-Ɂi¹²
séi²	V;IPFV;SG;1;PST	mi³-sei¹²	mi³-sei¹²
huen¹²	V;IPFV;SG;1;PST	mi³-huen¹³	mi³-huen¹²
rain¹²	V;IPFV;SG;1;PST	mi³-rain¹²	mi³-rain¹²
hog¹²	V;IPFV;SG;1;PST	mi³-hog¹²	mi³-hog¹²
chiúgɁ²	V;IPFV;SG;1;PST	mi³-chiugɁ³	mi³-chiugɁ³
lan²	V;IPFV;SG;1;PST	mi³-lan²	mi³-lan¹²
kuan¹²	V;IPFV;SG;1;PST	mi³-kuan¹²	mi³-kuan¹³
tsíɁ¹²	V;IPFV;SG;1;PST	mi³-tsøɁ²	mi³-tsiɁ¹²
tan¹³	V;IPFV;SG;1;PST	mi³-tan¹³	mi³-tan¹³
ɁiíɁ²	V;IPFV;SG;1;PST	mi³-ɁiiɁ¹²	mi³-ɁiiɁ²
hnóɁ²	V;IPFV;SG;1;PST	mi³-hnoɁ¹²	mi³-hnoɁ¹
ɁlíɁ¹²	V;IPFV;SG;1;PST	mi³-ɁliɁ¹²	mi³-ɁliɁ¹²
ku²+guénɁ²	V;IPFV;SG;1;PST	mi³-ku²+guenɁ³	mi³-ku²+guen
hnéi¹²	V;IPFV;SG;1;PST	mi³-hnai¹²	mi³-hnei¹²
koɁ¹²	V;IPFV;SG;1;PST	mi³-koɁ¹²	mi³-koɁ¹²
gúɁ¹²	V;IPFV;SG;1;PST	mi³-guɁ¹²	mi³-guɁ¹²
kánɁ¹²	V;IPFV;SG;1;PST	mi³-kanɁ¹³	mi³-kanɁ¹²
kionɁ¹²	V;IPFV;SG;1;PST	mi³-kionɁ¹²	mi³-kionɁ¹²
Ɂai¹²	V;IPFV;SG;1;PST	mi³-Ɂai¹²	mi³-Ɂai¹²
dsi²	V;IPFV;SG;1;PST	mi³-dsi¹²	mi³-dsi¹²
téng²	V;IPFV;SG;1;PST	mi³-ton¹²	mi³-teng²
chionɁ¹²	V;IPFV;SG;1;PST	mi³-chionɁ¹³	mi³-chionɁ¹
ngēɁ²	V;IPFV;SG;1;PST	mi³-ngēɁ²	mi³-ngēɁ¹
mi²+lei¹³	V;IPFV;SG;1;PST	mi³-mi²+lei¹³	mi³-mi²+lei¹
tógɁ¹²	V;IPFV;SG;1;PST	mi³-togɁ¹²	mi³-togɁ¹²
dsanɁ¹²	V;IPFV;SG;1;PST	mi³-dsanɁ¹²	mi³-dsanɁ¹²
téiɁ²	V;IPFV;SG;1;PST	mi³-teiɁ¹²	mi³-teiɁ¹
høn¹²	V;IPFV;SG;1;PST	mi³-høn¹²	mi³-høn¹²
kieng¹²	V;IPFV;SG;1;PST	mi³-kieng¹²	mi³-kieng¹²
mi²+dsē¹²	V;IPFV;SG;1;PST	mi³-mi²+dsē¹³	mi³-mi²+dsē¹
nǿɁ²	V;IPFV;SG;1;PST	mi³-nøɁ¹²	mi³-nøɁ¹²
tei²	V;IPFV;SG;1;PST	mi³-tei³	mi³-tei³²
kuø¹²	V;IPFV;SG;1;PST	mi³-kuø¹²	mi³-kuø¹²
kián²	V;IPFV;SG;1;PST	mi³-kian¹²	mi³-kian¹
ɁiuɁ³ (ɁéɁ¹)	V;IPFV;SG;1;PST	mi³-ɁiuɁ³	mi³-ɁiuɁ³³u³³¹
ɁiúɁ¹²	V;IPFV;SG;1;PST	mi³-ɁiuɁ³	mi³-ɁiuɁ¹²
hǿa¹²	V;IPFV;SG;1;PST	mi³-høa¹²	mi³-høa¹²
kiiɁ²	V;IPFV;SG;1;PST	mi³-kaɁ¹²	mi³-kiiɁ¹
hlǿ²	V;IPFV;SG;1;PST	mi³-hlø¹²	mi³-hlø¹²
tan¹²	V;IPFV;SG;1;PST	mi³-tan¹²	mi³-tan¹²
ko¹²	V;IPFV;SG;1;PST	mi³-ko¹²	mi³-ko¹²¹
tson¹²	V;IPFV;SG;1;PST	mi³-tson¹²	mi³-tson¹²
Ɂøin¹²	V;IPFV;SG;1;PST	mi³-Ɂøin²	mi³-Ɂøin¹²
dsióɁ¹² hǿg³	V;IPFV;SG;1;PST	mi³-dsioɁ¹²	mi³-dsioɁ¹²²Ɂ³
chi²+láɁ²	V;IPFV;SG;1;PST	mi³-chi²+laɁ¹²	mi³-chi²+laɁ
Ɂen¹³	V;IPFV;SG;1;PST	mi³-Ɂen¹³	mi³-Ɂen¹³
tanɁ¹²	V;IPFV;SG;1;PST	mi³-tanɁ²	mi³-tanɁ¹²
siúɁ²	V;IPFV;SG;1;PST	mi³-siuɁ¹²	mi³-siuɁ³
hlian¹²	V;IPFV;SG;1;PST	mi³-hlian¹²	mi³-hlian¹²
tion¹²	V;IPFV;SG;1;PST	mi³-ton¹²	mi³-tion¹²
chiógɁ² ( hmøi²)	V;IPFV;SG;1;PST	mi³-chiogɁ³	mi³-chiogɁ³²g¹²²
mi²+hngiáng¹	V;IPFV;SG;1;PST	mi³-mi²+hngiang¹³	mi³-mi²+hngian
Ɂlí²	V;IPFV;SG;1;PST	mi³-Ɂli¹²	mi³-Ɂli¹²
húg²	V;IPFV;SG;1;PST	mi³-hug²	mi³-hug¹²
ɁlogɁ²	V;IPFV;SG;1;PST	mi³-ɁlogɁ²	mi³-ɁlogɁ¹
mi²+ɁmaɁ¹³	V;IPFV;SG;1;PST	mi³-mi²+ɁmaɁ¹³	mi³-mi²+ɁmaɁ
siág¹²	V;IPFV;SG;1;PST	mi³-siog³	mi³-siag¹²
mi²+hog¹²	V;IPFV;SG;1;PST	mi³-mi²+hog³	mi³-mi²+hog³
ɁløaɁ¹²	V;IPFV;SG;1;PST	mi³-ɁløaɁ³	mi³-ɁløaɁ¹²
dsúgɁ¹²	V;IPFV;SG;1;PST	mi³-dsugɁ¹²	mi³-dsugɁ¹²
héi²	V;IPFV;SG;1;PST	mi³-hi²	mi³-hei¹²
hnia¹²	V;IPFV;SG;1;PST	mi³-hnia¹²	mi³-hnia¹²
hnḗ¹²	V;IPFV;SG;1;PST	mi³-hnē¹²	mi³-hnē¹²
ɁóɁ¹²	V;IPFV;SG;1;PST	mi³-Ɂog¹²	mi³-ɁoɁ¹²
mi²+tián² (dsǿa¹²)	V;IPFV;SG;1;PST	mi³-mi²+tian³	mi³-mi²+tian³³(((
u²+nio¹³	V;IPFV;SG;1;PST	mi³-u²+nio¹²	mi³-u²+nio¹
mi²+Ɂog¹³	V;IPFV;SG;1;PST	mi³-mi²+Ɂog³	mi³-mi²+Ɂog³
dsiánɁ²	V;IPFV;SG;1;PST	mi³-dsianɁ³	mi³-dsianɁ¹
tsø²+nióɁ²	V;IPFV;SG;1;PST	mi³-tsø²+nioɁ³	mi³-tsø²+nio
mi²+Ɂan¹³	V;IPFV;SG;1;PST	mi³-mi²+Ɂan¹³	mi³-mi²+Ɂan¹
kuú²	V;IPFV;SG;1;PST	mi³-kuu²	mi³-kuu²²
iéiɁ¹²	V;IPFV;SG;1;PST	mi³-ieiɁ¹²	mi³-ieiɁ¹²
hmo¹²	V;IPFV;SG;1;PST	mi³-hmo¹²	mi³-hmo¹²
nei¹²	V;IPFV;SG;1;PST	mi³-nei³	mi³-nei¹²
tei¹²	V;IPFV;SG;1;PST	mi³-tei¹²	mi³-tei¹²
mi²+hniang¹ dsǿa¹²	V;IPFV;SG;1;PST	mi³-mi²+hniang³	mi³-mi²+hniang³¹³
rang¹²	V;IPFV;SG;1;PST	mi³-rang¹²	mi³-rang¹²
hínɁ¹²	V;IPFV;SG;1;PST	mi³-hinɁ³	mi³-hinɁ³²
ɁmíɁ²	V;IPFV;SG;1;PST	mi³-ɁmiɁ²	mi³-ɁmiɁ²
hiég²	V;IPFV;SG;1;PST	mi³-hieg¹²	mi³-hieg¹
Ɂēn¹²	V;IPFV;SG;1;PST	mi³-Ɂēn²	mi³-Ɂēn¹²
ɁéɁ¹²	V;IPFV;SG;1;PST	mi³-ɁeɁ¹²	mi³-ɁeɁ¹²
gḗɁ²	V;IPFV;SG;1;PST	mi³-gēɁ²	mi³-gēɁ²²
ɁagɁ²	V;IPFV;SG;1;PST	mi³-ɁagɁ³	mi³-ɁagɁ¹
mi²+ténɁ²	V;IPFV;SG;1;PST	mi³-mi²+tenɁ³	mi³-mi²+tenɁ
ɁmiɁ¹²	V;IPFV;SG;1;PST	mi³-ɁmiɁ³	mi³-ɁmiɁ³²
háng¹²	V;IPFV;SG;1;PST	mi³-hang³	mi³-hang¹²
nung²	V;IPFV;SG;1;PST	mi³-nung¹²	mi³-nung²
kḗn²	V;IPFV;SG;1;PST	mi³-kēn²	mi³-kēn²²
ton²	V;IPFV;SG;1;PST	mi³-ton²	mi³-ton¹²
iaɁ¹²	V;IPFV;SG;1;PST	mi³-iaɁ³	mi³-iaɁ³²
ngo²	V;IPFV;SG;1;PST	mi³-ngo²	mi³-ngo²²
hug²	V;IPFV;SG;1;PST	mi³-hug²	mi³-hug¹³
kiúɁ¹²	V;IPFV;SG;1;PST	mi³-kiuɁ¹²	mi³-kiuɁ¹²
guiágɁ¹²	V;IRR;2;FUT	guiagɁ¹³	guiagɁ¹
bø²+hmé²	V;IRR;2;FUT	bø¹+hme³	bø¹+hme
dsánɁ¹²	V;IRR;2;FUT	dsianɁ¹²	dsanɁ¹
Ɂuø¹²	V;IRR;2;FUT	Ɂuø³	Ɂuø³²
guión²	V;IRR;2;FUT	guion³	guion¹
lǿɁ²	V;IRR;2;FUT	leɁ²	løɁ¹³
tií²	V;IRR;2;FUT	tii¹³	tii¹³
guiénɁ²	V;IRR;2;FUT	guienɁ¹³	guienɁ
héinɁ¹²	V;IRR;2;FUT	heinɁ³	heinɁ³
Ɂien¹²	V;IRR;2;FUT	Ɂien¹³	Ɂien³³
mi²+kionɁ¹	V;IRR;2;FUT	mi¹+kionɁ¹³	mi¹+kion
hénɁ²	V;IRR;2;FUT	henɁ¹³	henɁ¹
hǿɁ¹²	V;IRR;2;FUT	tsøɁ³	høɁ¹³
chi²+dsán²	V;IRR;2;FUT	chi¹+dsan³	chi¹+dsa
mi²+dsøg¹²	V;IRR;2;FUT	mi¹+dsøg¹³	mi¹+dsøg
mi²+chian¹²	V;IRR;2;FUT	mi¹+chian³	mi¹+chian
guiúg²	V;IRR;2;FUT	guiug³	guiug³
niá¹²	V;IRR;2;FUT	nia¹	nia¹³
Ɂan¹²	V;IRR;2;FUT	Ɂan¹³	Ɂan³³
dsian¹²	V;IRR;2;FUT	dsian¹³	dsian¹
dság¹²	V;IRR;2;FUT	gogɁ³	dsag³³
hmóngɁ¹²	V;IRR;2;FUT	hmongɁ³	hmongɁ¹
chi²+dsí²	V;IRR;2;FUT	chi¹+dsi³	chi¹+dsi
tánɁ¹²	V;IRR;2;FUT	tanɁ¹³	tanɁ³³
kuøin¹²	V;IRR;2;FUT	kuøin¹³	kuøin¹
tsø²+nióɁ¹²	V;IRR;2;FUT	tsø¹+nioɁ¹	tsø¹+nioɁ
mi²+hénɁ²	V;IRR;2;FUT	mi¹+henɁ³	mi¹+henɁ
ti²+líɁ¹	V;IRR;2;FUT	ti¹+leɁ¹	ti¹+leɁ
hánɁ¹²	V;IRR;2;FUT	hanɁ¹	hanɁ³³
hiúg²	V;IRR;2;FUT	hiug³	hiug³
hinɁ³	V;IRR;2;FUT	hinɁ¹	hinɁ¹
mi²+hmḗ²	V;IRR;2;FUT	mi¹+hmē³	mi¹+hmē
ngē¹²	V;IRR;2;FUT	ngē¹²	ngē¹³
tión²	V;IRR;2;FUT	ton³	tion³
tsø²+kuenɁ¹²	V;IRR;2;FUT	tsø¹+kuenɁ¹²	tsø¹+kuenɁ
hngiáɁ²	V;IRR;2;FUT	hngiaɁ³	hngiaɁ
ngioɁ¹²	V;IRR;2;FUT	ngioɁ³	ngioɁ³
ngøa¹²	V;IRR;2;FUT	ngøa³	ngøa³³
hngióɁ¹²	V;IRR;2;FUT	hngioɁ¹³	hngioɁ³
se¹²	V;IRR;2;FUT	se¹³	se¹³¹
tsǿɁ¹²	V;IRR;2;FUT	tsøɁ¹³	tsøɁ¹³
ta¹²	V;IRR;2;FUT	ta³	ta³³³
ha²+Ɂan³	V;IRR;2;FUT	ha¹+Ɂan³	ha¹+Ɂan
kúgɁ¹²	V;IRR;2;FUT	kugɁ¹³	kugɁ³³
huúɁ¹²	V;IRR;2;FUT	huuɁ³	huuɁ³³
kágɁ¹²	V;IRR;2;FUT	kagɁ³	kagɁ³³
guái²	V;IRR;2;FUT	guai¹³	guai¹
hḗnɁ²	V;IRR;2;FUT	hēnɁ¹³	hēnɁ¹
mi²+hnia¹²	V;IRR;2;FUT	mi¹+hnia¹³	mi¹+hnia
chi²+kián²	V;IRR;2;FUT	chi¹+kian³	chi¹+kia
ku² hmo¹²	V;IRR;2;FUT	ku³	ku³¹¹³¹²
kión²	V;IRR;2;FUT	kion³	kion¹
téiɁ¹²	V;IRR;2;FUT	teiɁ³	teiɁ³³
lóɁ¹²	V;IRR;2;FUT	loɁ³	loɁ³Ɂ
hnḗɁ²	V;IRR;2;FUT	hnēɁ³	hnēɁ³
ɁóɁ²	V;IRR;2;FUT	ɁoɁ¹³	ɁoɁ³Ɂ
ngē²	V;IRR;2;FUT	ngie¹	ngē¹³
mi²+dsēn¹²	V;IRR;2;FUT	mi¹+dsēn¹³	mi¹+dsēn
mi²+ɁḗɁ²	V;IRR;2;FUT	mi¹+ɁēɁ³	mi¹+ɁēɁ
tø²+ɁénɁ¹²	V;IRR;2;FUT	tø¹+ɁenɁ³	tø¹+ɁenɁ
rón²	V;IRR;2;FUT	ron³	ron³³
Ɂo¹²	V;IRR;2;FUT	Ɂøg³	Ɂog³¹
hǿɁ²	V;IRR;2;FUT	høɁ¹³	høɁ¹³
hnǿ²	V;IRR;2;FUT	hnø¹³	hnø¹³
hnaiɁ¹²	V;IRR;2;FUT	hnaiɁ³	hnaiɁ³
tai²	V;IRR;2;FUT	tai³	tai³³
mi²+tan¹³	V;IRR;2;FUT	mi¹+tan¹³	mi¹+tan¹
ɁuǿɁ¹²	V;IRR;2;FUT	ɁuøɁ¹³	ɁuøɁ¹³
guønɁ¹²	V;IRR;2;FUT	guønɁ¹	guønɁ¹
kán²	V;IRR;2;FUT	kan³	kan³³
háinɁ¹²	V;IRR;2;FUT	hainɁ³	hainɁ³
dsø²+huen¹³	V;IRR;2;FUT	dsø¹+huen¹³	dsø¹+huen
lag²	V;IRR;2;FUT	lag¹³	lag³³
huú²	V;IRR;2;FUT	huø¹³	huu³³
bán²	V;IRR;2;FUT	ban¹³	ban¹³
mi²+tég²	V;IRR;2;FUT	mi¹+teg³	mi¹+teg
guøn¹²	V;IRR;2;FUT	guøn²	guøn³¹
mi²+gug¹	V;IRR;2;FUT	mi¹+gug¹	mi¹+gug
rǿnɁ¹²	V;IRR;2;FUT	rønɁ³	rønɁ³³
gog²	V;IRR;2;FUT	gog¹³	gog¹³
lán¹²	V;IRR;2;FUT	len²	lan³¹
niá²	V;IRR;2;FUT	na³	nia¹³
Ɂno¹²	V;IRR;2;FUT	Ɂnøng³	Ɂno³g
mi²+kien¹²	V;IRR;2;FUT	mi¹+kien¹³	mi¹+kien
chióɁ¹²	V;IRR;2;FUT	chioɁ³	chioɁ³
ngiéɁ¹²	V;IRR;2;FUT	ngieɁ³	ngieɁ³
siúg²	V;IRR;2;FUT	siog³	siug³
huánɁ²	V;IRR;2;FUT	huanɁ¹³	huanɁ¹
dsiag¹²	V;IRR;2;FUT	dsiag³	dsiag³
teng¹²	V;IRR;2;FUT	tøng³	teng³³
mi²+kon¹²	V;IRR;2;FUT	mi¹+kon³	mi¹+kon³
hanɁ¹² dsǿa¹²	V;IRR;2;FUT	hanɁ¹	hanɁ¹i³³¹²
méɁ²	V;IRR;2;FUT	meɁ¹³	meɁ³³
ngié²	V;IRR;2;FUT	ngie²	ngie¹
ɁnáiɁ¹²	V;IRR;2;FUT	ɁnaiɁ³	ɁnaiɁ³
hnio³	V;IRR;2;FUT	hnio¹	hnio¹
ténɁ¹²	V;IRR;2;FUT	tenɁ³	tenɁ³³
guǿn¹²	V;IRR;2;FUT	guøn¹³	guøn¹³
tán¹²	V;IRR;2;FUT	tēn¹³	tan¹³
tson²	V;IRR;2;FUT	chion¹	tson¹
Ɂio¹²	V;IRR;2;FUT	Ɂøg³	Ɂio³Ɂ
hen¹²	V;IRR;2;FUT	hen³	hen³³
hián²	V;IRR;2;FUT	hian²	hian¹
kii²+tág¹²	V;IRR;2;FUT	kii¹+tag³	kii¹+tag
hngia¹²	V;IRR;2;FUT	han¹³	han¹³³
dsoɁ²	V;IRR;2;FUT	dsioɁ¹	dsiɁ¹
Ɂán²	V;IRR;2;FUT	Ɂan³	Ɂan¹³
køn¹²	V;IRR;2;FUT	køn³	køn³³
Ɂiog²	V;IRR;2;FUT	Ɂiog¹	Ɂiog¹
tsog²	V;IRR;2;FUT	tsog¹	tsog¹
mi²+tsḗn¹	V;IRR;2;FUT	mi¹+tsēn¹³	mi¹+tsēn
kugɁ¹²	V;IRR;2;FUT	kugɁ¹³	kugɁ¹³
tsǿaɁ¹²	V;IRR;2;FUT	tsøaɁ³	tsøaɁ³
hne¹²	V;IRR;2;FUT	hnøa³	hnø³³
ɁioɁ¹²	V;IRR;2;FUT	ɁianɁ¹³	ɁioɁ¹³
ku²+hmáɁ²	V;IRR;2;FUT	ku¹+hmaɁ¹³	ku¹+hmaɁ
hág¹²	V;IRR;2;FUT	hag¹³	hag¹³
hmóɁ¹²	V;IRR;2;FUT	hmoɁ³	hmoɁ³¹
húɁ²	V;IRR;2;FUT	huɁ³	huɁ³³
Ɂnia¹²	V;IRR;2;FUT	Ɂnia¹³	Ɂnia³³
héin¹²	V;IRR;2;FUT	hein³	hein³³
ngie¹²	V;IRR;2;FUT	ngie¹³	ngie³³
dsiánɁ¹²	V;IRR;2;FUT	dsianɁ¹³	dsianɁ¹
kieg²	V;IRR;2;FUT	køg¹³	kieg¹
køin²	V;IRR;2;FUT	køin¹³	køin¹
chiáng¹²	V;IRR;2;FUT	chiang³	chiang³
kióɁ¹²	V;IRR;2;FUT	kioɁ³	kioɁ³³
møa¹²	V;IRR;2;FUT	møa³	møa³³
guen²	V;IRR;2;FUT	guen¹	guen¹
tug	V;IRR;2;FUT	tiug¹²	tiug
hngēɁ¹²	V;IRR;2;FUT	hngēɁ³	hngēɁ³
hmǿɁ¹²	V;IRR;2;FUT	hmøɁ³	hmøɁ³³
tsénɁ²	V;IRR;2;FUT	tsēnɁ³	tsenɁ³
chiunɁ¹²	V;IRR;2;FUT	chiunɁ³	chiunɁ³
tióɁ¹²	V;IRR;2;FUT	tianɁ¹	tioɁ³³
tø²+húg³	V;IRR;2;FUT	tø¹+hug³	tø¹+hug
tsēn¹²	V;IRR;2;FUT	tsēn³	tsēn³¹
mi²+Ɂlí¹	V;IRR;2;FUT	mi¹+Ɂli³	mi¹+Ɂli
dsen³ (kaɁ³)	V;IRR;2;FUT	dsen³	dsen³³²¹³n
chiogɁ¹²	V;IRR;2;FUT	chiogɁ¹	chiogɁ¹
chi²+méɁ²	V;IRR;2;FUT	chi¹+meɁ¹³	chi¹+meɁ
chi²+lánɁ²	V;IRR;2;FUT	chi¹+lanɁ¹³	chi¹+lan
hánɁ²	V;IRR;2;FUT	hanɁ¹³	hanɁ¹
tsø²+kuønɁ¹²	V;IRR;2;FUT	tsø¹+kuønɁ¹²	tsø¹+kuønɁ
uǿi²	V;IRR;2;FUT	uøi³	uøi³¹
tø²+gugɁ¹²	V;IRR;2;FUT	tø¹+gugɁ¹³	tø¹+gugɁ
mi²+hlíɁ²	V;IRR;2;FUT	mi¹+hliɁ³	mi¹+hliɁ
mi²+níɁ¹	V;IRR;2;FUT	mi¹+niɁ³	mi¹+niɁ
búɁ²	V;IRR;2;FUT	buɁ¹³	buɁ¹³
Ɂiei¹²	V;IRR;2;FUT	Ɂiei³	Ɂiei¹³
niuɁ³	V;IRR;2;FUT	niuɁ¹	niuɁ¹
hngiángɁ¹²	V;IRR;2;FUT	hngiangɁ³	hngiangɁ
tsø²+han¹²	V;IRR;2;FUT	tsø¹+han¹	tsø¹+han
kién¹²	V;IRR;2;FUT	kien¹³	kien¹³
hḗn²	V;IRR;2;FUT	hēn¹³	hēn¹³
ngai¹²	V;IRR;2;FUT	ngai³	ngai³³
mi²+hngió¹	V;IRR;2;FUT	mi¹+hngio¹³	mi¹+hngi
hmḗɁ²	V;IRR;2;FUT	hmēɁ³	hmēɁ³
mi²+dsíg²	V;IRR;2;FUT	mi¹+dsig³	mi¹+dsig
tǿɁ²	V;IRR;2;FUT	tøa¹³	tøɁ¹³
hnáɁ²	V;IRR;2;FUT	hnaɁ³	hnaɁ¹
huúɁ²	V;IRR;2;FUT	huuɁ³	huuɁ³
mi²+gan¹²	V;IRR;2;FUT	mi¹+gan¹³	mi¹+gan¹
lieɁ¹²	V;IRR;2;FUT	laɁ³	lieɁ¹³
ti²+dsǿ²	V;IRR;2;FUT	ti¹+dsø³	ti¹+dsø
chiag¹²	V;IRR;2;FUT	chiag³	chiag³
guen¹²	V;IRR;2;FUT	guen³	guen³³
tónɁ² (huu¹²)	V;IRR;2;FUT	tonɁ³	tonɁ³¹¹²³¹
hogɁ¹²	V;IRR;2;FUT	hogɁ¹²	hogɁ³²
mi²+kánɁ²	V;IRR;2;FUT	mi¹+kanɁ³	mi¹+kanɁ
Ɂuan¹²	V;IRR;2;FUT	Ɂuan¹³	Ɂuan¹³
li²	V;IRR;2;FUT	li¹³	li¹³
kēnɁ¹²	V;IRR;2;FUT	kēnɁ³	kēnɁ³³
dsióɁ¹²	V;IRR;2;FUT	dsioɁ³	dsioɁ³
tsiɁ¹²	V;IRR;2;FUT	tsøɁ³	tsiɁ³³
kiéɁ¹²	V;IRR;2;FUT	kieɁ³	kieɁ¹³
tsánɁ²	V;IRR;2;FUT	tsanɁ¹³	tsanɁ¹
héɁ²	V;IRR;2;FUT	heɁ³	heɁ³³
ɁnióɁ¹²	V;IRR;2;FUT	ɁnioɁ¹³	ɁnioɁ³
ngiú²	V;IRR;2;FUT	ngiu³	ngiu³
lúg²	V;IRR;2;FUT	liug²	lug³²
tag¹²	V;IRR;2;FUT	tøg³	tag¹³
ɁiánɁ²	V;IRR;2;FUT	ɁianɁ¹³	ɁianɁ¹
mi²+Ɂai¹	V;IRR;2;FUT	mi¹+Ɂai¹	mi¹+Ɂai
tsí¹²	V;IRR;2;FUT	tsi³	tsi³³
kiog¹²	V;IRR;2;FUT	kog³	kiog³¹
chi²+dsén²	V;IRR;2;FUT	chi¹+dsen¹³	chi¹+dse
hlán²	V;IRR;2;FUT	hlan³	hlan¹
u¹+lén²	V;IRR;2;FUT	u¹+len¹³	u¹+len
tsen¹²	V;IRR;2;FUT	tsēn³	tsen³³
hliúg² (lag³ dsi³)	V;IRR;2;FUT	hliug¹³	hliug¹³²³¹³²(
dsán²	V;IRR;2;FUT	dsan¹³	dsan¹
tiun¹²	V;IRR;2;FUT	tøng¹³	tiun³³
dsǿɁ²	V;IRR;2;FUT	dsøɁ¹³	dsøɁ¹
ha¹²	V;IRR;2;FUT	ha¹³	ha¹³³
guian¹²	V;IRR;2;FUT	guian¹³	guian¹
ti²+li¹	V;IRR;2;FUT	ti¹+li³	ti¹+li
mi²+ngḗɁ¹	V;IRR;2;FUT	mi¹+ngēɁ³	mi¹+ngēɁ
Ɂien²	V;IRR;2;FUT	Ɂien¹	Ɂien¹
mi²+kuen¹²	V;IRR;2;FUT	mi¹+kuen¹³	mi¹+kuen
mi²+gǿg¹	V;IRR;2;FUT	mi¹+gøg¹	mi¹+gøg
Ɂmǿi²	V;IRR;2;FUT	Ɂmai¹³	Ɂmai¹
chi²+ngió²	V;IRR;2;FUT	chi¹+ngio³	chi¹+ngi
ti²+dsiog¹	V;IRR;2;FUT	ti¹+dsiog³	ti¹+dsio
Ɂnē¹²	V;IRR;2;FUT	Ɂnē¹³	Ɂnē¹³
Ɂngieng¹²	V;IRR;2;FUT	Ɂngieng³	Ɂngg¹³g³
hlég²	V;IRR;2;FUT	hleg²	hleg³
dsii²+lian¹	V;IRR;2;FUT	dsii¹+lian¹	dsii¹+lia
hné¹²	V;IRR;2;FUT	hnē³	hne³³
tsón²	V;IRR;2;FUT	tson³	tson³
húgɁ²	V;IRR;2;FUT	hogɁ¹³	hugɁ¹
mái¹²	V;IRR;2;FUT	mai³	mai³³
kiáɁ²	V;IRR;2;FUT	kiaɁ¹³	kiaɁ¹
mi²+rø¹²	V;IRR;2;FUT	mi¹+rø³	mi¹+rø³
tiú²	V;IRR;2;FUT	tiu¹³	tiu¹³
kií¹²	V;IRR;2;FUT	kø³	kii³³
mi²+hínɁ²	V;IRR;2;FUT	mi¹+hinɁ³	mi¹+hinɁ
tián²	V;IRR;2;FUT	tian¹³	tian¹
ɁnáɁ¹²	V;IRR;2;FUT	ɁnaɁ¹³	ɁnaɁ³³
ɁliuɁ¹²	V;IRR;2;FUT	ɁliuɁ³	ɁliuɁ³
tso¹²	V;IRR;2;FUT	høg³	tso³Ɂ
siég²	V;IRR;2;FUT	sieg¹³	sieg¹
sianɁ¹²	V;IRR;2;FUT	sianɁ¹³	sianɁ³
nió²	V;IRR;2;FUT	nio¹³	nio¹³
kien¹²	V;IRR;2;FUT	kien¹³	kien³³
tsén²	V;IRR;2;FUT	tsen³	tsen¹
búɁ¹²	V;IRR;2;FUT	buɁ¹³	buɁ¹³
Ɂuan²	V;IRR;2;FUT	Ɂuen³	Ɂuan¹
mi²+hniang¹ ni³	V;IRR;2;FUT	mi¹+hniang³	mi¹+hniang³²
kúgɁ²	V;IRR;2;FUT	kogɁ³	kugɁ¹
ɁngióɁ¹²	V;IRR;2;FUT	ɁngioɁ³	ɁngioɁ³
Ɂma¹²	V;IRR;2;FUT	Ɂma¹³	Ɂma¹³
chiágɁ¹²	V;IRR;2;FUT	chiagɁ³	chiagɁ³
hiégɁ¹²	V;IRR;2;FUT	hiegɁ³	hiegɁ³
mi²+Ɂliúg²	V;IRR;2;FUT	mi¹+Ɂliug³	mi¹+Ɂliu
mi²+dsií¹	V;IRR;2;FUT	mi¹+dsii³	mi¹+dsii
tanɁ¹² huu¹²	V;IRR;2;FUT	tanɁ³	tanɁ³²³²¹³
Ɂug¹²	V;IRR;2;FUT	Ɂug¹³	Ɂug¹³
hái¹²	V;IRR;2;FUT	hai³	hai³³
ián²	V;IRR;2;FUT	ian¹³	ian¹³
hén²	V;IRR;2;FUT	hen³	hen¹³
mi²+Ɂan¹²	V;IRR;2;FUT	mi¹+lig2¹³	mi¹+lig2
hngieng¹²	V;IRR;2;FUT	hang¹³	hangeng³
tsai¹²	V;IRR;2;FUT	tsai¹³	tsai³³
pø²+hánɁ²	V;IRR;2;FUT	pø¹+hanɁ¹³	pø¹+hanɁ
bí²	V;IRR;2;FUT	bi¹³	bi¹³
Ɂø²+tsúgɁ²	V;IRR;2;FUT	Ɂø¹+tsogɁ²	Ɂø¹+tsog
ɁaiɁ²	V;IRR;2;FUT	ɁaiɁ¹³	ɁaiɁ¹
Ɂéi¹²	V;IRR;2;FUT	Ɂei¹³	Ɂei³³
mi²+kiín¹	V;IRR;2;FUT	mi¹+kiin³	mi¹+kiin
ié²	V;IRR;2;FUT	ie¹³	ie¹³
hønɁ¹²	V;IRR;2;FUT	hønɁ³	hønɁ³³
tsøi¹²	V;IRR;2;FUT	tsøi¹³	tsøi³³
gúg²	V;IRR;2;FUT	gug¹³	gug¹³
kuǿɁ¹²	V;IRR;2;FUT	kuøɁ¹³	kuøɁ¹³
Ɂuǿi²	V;IRR;2;FUT	Ɂuai¹³	Ɂuai¹
hnióɁ²	V;IRR;2;FUT	hnioɁ²	hnioɁ³
Ɂe¹²	V;IRR;2;FUT	Ɂe³	Ɂe³³¹
nang¹²	V;IRR;2;FUT	nøng³	nang³³
kuénɁ²	V;IRR;2;FUT	kuenɁ³	kuenɁ³
ngó¹²	V;IRR;2;FUT	ngo³	ngo³³
mē¹²	V;IRR;2;FUT	mē¹³	mē¹³³
mi²+kiónɁ²	V;IRR;2;FUT	mi¹+kionɁ³	mi¹+kion
kiagɁ¹²	V;IRR;2;FUT	kiagɁ³	kiagɁ¹
lio¹²	V;IRR;2;FUT	løg³	lig³Ɂ
ɁmóɁ²	V;IRR;2;FUT	ɁmoɁ¹³	ɁmoɁ³
hniang²	V;IRR;2;FUT	hniang¹	hniang
tian¹	V;IRR;2;FUT	tian¹	tian¹
guiugɁ²	V;IRR;2;FUT	guiugɁ¹	guiugɁ
ɁmēɁ¹²	V;IRR;2;FUT	ɁmēɁ³	ɁmēɁ³³
mi²+hní¹	V;IRR;2;FUT	mi¹+hni³	mi¹+hni
nié¹²	V;IRR;2;FUT	na³	nie¹¹
hngióɁ²	V;IRR;2;FUT	hngioɁ³	hngioɁ
ɁenɁ¹²	V;IRR;2;FUT	ɁenɁ¹³	ɁenɁ¹³
tsēnɁ¹²	V;IRR;2;FUT	tsenɁ¹²	tsēnɁ¹
ɁøɁ¹²	V;IRR;2;FUT	ɁøɁ³	ɁøɁ³³
mḗɁ²	V;IRR;2;FUT	mēɁ³	mēɁ³³
kang²	V;IRR;2;FUT	kang³	kang³
liúg²	V;IRR;2;FUT	log³	liug³
ngǿi²	V;IRR;2;FUT	ngai¹³	ngai¹
togɁ¹²	V;IRR;2;FUT	togɁ³	togɁ³³
kø²+hinɁ¹²	V;IRR;2;FUT	kø¹+hinɁ³	kø¹+hinɁ
guenɁ¹²	V;IRR;2;FUT	guenɁ³	guenɁ³
hénɁ¹²	V;IRR;2;FUT	henɁ¹³	henɁ³³
Ɂen¹²	V;IRR;2;FUT	Ɂen³	Ɂen³³
lánɁ²	V;IRR;2;FUT	lanɁ¹³	lanɁ¹
ngie³	V;IRR;2;FUT	ngie³	ngie¹
ngieɁ¹³	V;IRR;2;FUT	ngieɁ¹³	ngieɁ¹
lióg¹²	V;IRR;2;FUT	log¹³	liog³¹
mi²+gan¹	V;IRR;2;FUT	mi¹+gan¹	mi¹+gan
kón²	V;IRR;2;FUT	kon³	kon³³
ɁliágɁ¹²	V;IRR;2;FUT	ɁliagɁ³	ɁliagɁ³
ɁéɁ²	V;IRR;2;FUT	ɁeɁ³	ɁeɁ³³
hngió²	V;IRR;2;FUT	hngio¹³	hngio¹
Ɂé²	V;IRR;2;FUT	Ɂe²	Ɂe¹³
Ɂmóng¹²	V;IRR;2;FUT	Ɂmong¹³	Ɂmong¹
Ɂog¹²	V;IRR;2;FUT	Ɂog¹	Ɂog¹³
kø¹²	V;IRR;2;FUT	kø³	kø³³²
u¹+lian¹	V;IRR;2;FUT	u¹+lian¹	u¹+lian
tø²+dsḗn³	V;IRR;2;FUT	tø¹+dsēn³	tø¹+dsēn
kēn²	V;IRR;2;FUT	kēn³	kēn³³
kiang¹²	V;IRR;2;FUT	kiang¹³	kiang¹
ɁánɁ²	V;IRR;2;FUT	ɁanɁ¹³	ɁanɁ¹
ɁlanɁ¹²	V;IRR;2;FUT	ɁlanɁ¹³	ɁlanɁ¹
guiánɁ¹²	V;IRR;2;FUT	guianɁ¹³	guianɁ¹
hlíɁ¹²	V;IRR;2;FUT	hløɁ³	hliɁ³³
ɁlieɁ¹²	V;IRR;2;FUT	ɁlieɁ³	ɁlieɁ³
huen¹²	V;IRR;2;FUT	huen¹³	huen¹³
ieg¹²	V;IRR;2;FUT	øg³	ieg³³
køgɁ²	V;IRR;2;FUT	køgɁ³	køgɁ¹
chiúgɁ²	V;IRR;2;FUT	chiugɁ³	chiugɁ
lan²	V;IRR;2;FUT	lan³	lan³³
ɁénɁ¹²	V;IRR;2;FUT	ɁenɁ¹³	ɁenɁ³³
tsá¹²	V;IRR;2;FUT	tsa³	tsa³³
kuan¹²	V;IRR;2;FUT	kuan¹³	kuan¹³
siog²	V;IRR;2;FUT	siog¹³	siog¹
guiég¹²	V;IRR;2;FUT	guieg³	guieg³
huu¹²	V;IRR;2;FUT	huu³	huu³¹
tsíɁ¹²	V;IRR;2;FUT	tsøɁ³	tsiɁ³³
tan¹³	V;IRR;2;FUT	tan¹³	tan¹³
ɁiíɁ²	V;IRR;2;FUT	ɁiiɁ¹³	ɁiiɁ¹
ɁlíɁ¹²	V;IRR;2;FUT	ɁliɁ¹³	ɁliɁ³³
hnéi¹²	V;IRR;2;FUT	hnai³	hnei³³
koɁ¹²	V;IRR;2;FUT	koɁ¹³	koɁ³³
Ɂán¹² ɁogɁ¹²	V;IRR;2;FUT	Ɂan¹³	Ɂan¹³³¹³³³
kionɁ¹²	V;IRR;2;FUT	kionɁ¹³	kionɁ¹
Ɂai¹²	V;IRR;2;FUT	Ɂøi³	Ɂai³³
mi²+dsiagɁ¹	V;IRR;2;FUT	mi¹+dsiagɁ³	mi¹+dsiag
mi²+ti¹	V;IRR;2;FUT	mi¹+ti³	mi¹+ti
ngēɁ²	V;IRR;2;FUT	ngēɁ¹	ngēɁ¹
mi²+lei¹³	V;IRR;2;FUT	mi¹+lei¹³	mi¹+lei¹
tógɁ¹²	V;IRR;2;FUT	tugɁ³	togɁ³¹
guuɁ¹²	V;IRR;2;FUT	guuɁ³	guuɁ¹³
ɁlianɁ¹²	V;IRR;2;FUT	ɁlianɁ¹³	ɁlianɁ¹
dsanɁ¹²	V;IRR;2;FUT	dsianɁ¹²	dsanɁ¹
téiɁ²	V;IRR;2;FUT	teiɁ¹³	teiɁ¹
neɁ¹²	V;IRR;2;FUT	neɁ³	neɁ³³
mi²+gag¹²	V;IRR;2;FUT	mi¹+gag¹³	mi¹+gag¹
høn¹²	V;IRR;2;FUT	høn³	høn³³
hógɁ¹²	V;IRR;2;FUT	hiugɁ¹³	hogɁ³¹
mi²+dsē¹²	V;IRR;2;FUT	mi¹+dsē¹³	mi¹+dsē¹
nǿɁ²	V;IRR;2;FUT	nøɁ¹³	nøɁ¹³
hngiú²	V;IRR;2;FUT	hngiu¹³	hngiu¹
tei²	V;IRR;2;FUT	tei³	tei³³
kuø¹²	V;IRR;2;FUT	kuø³	kuø³²
kián²	V;IRR;2;FUT	kian¹³	kian¹
dsén²	V;IRR;2;FUT	dsen¹³	dsen¹
ɁiuɁ³ (ɁéɁ¹)	V;IRR;2;FUT	ɁiuɁ³	ɁiuɁ³³³³o¹
ɁiúɁ¹²	V;IRR;2;FUT	ɁiuɁ³	ɁiuɁ³¹
tan¹²	V;IRR;2;FUT	tan¹	tan³³
ko¹²	V;IRR;2;FUT	køg³	kog³¹
len¹² dsǿa¹²	V;IRR;2;FUT	len¹	len¹³i¹³¹³
tiu¹²	V;IRR;2;FUT	tiu³	tiu³³
tson¹²	V;IRR;2;FUT	tson¹	tson³¹
dsióɁ¹² hǿg³	V;IRR;2;FUT	dsioɁ¹³	dsioɁ¹³²¹³
chi²+láɁ²	V;IRR;2;FUT	chi¹+laɁ¹³	chi¹+laɁ
hai¹²	V;IRR;2;FUT	høi³	hai³³
Ɂen¹³	V;IRR;2;FUT	Ɂen¹³	Ɂen¹³
tanɁ¹²	V;IRR;2;FUT	tanɁ³	tanɁ³³
siúɁ²	V;IRR;2;FUT	siuɁ¹³	siuɁ¹
ɁnangɁ²	V;IRR;2;FUT	ɁnangɁ¹³	ɁnangɁ
hlian¹²	V;IRR;2;FUT	hlian¹	hlian¹
tion¹²	V;IRR;2;FUT	ton¹³	tion¹¹
chiógɁ² ( hmøi²)	V;IRR;2;FUT	chiogɁ³	chiogɁ³³³¹³²
Ɂø²+tsóɁ¹²	V;IRR;2;FUT	Ɂø¹+tsoɁ³	Ɂø¹+tsoɁ
nøɁ¹²	V;IRR;2;FUT	nøɁ³	nøɁ³³
húg²	V;IRR;2;FUT	hug²	hug¹³
ɁlogɁ²	V;IRR;2;FUT	ɁlogɁ¹	ɁlogɁ¹
mi²+ɁmaɁ¹³	V;IRR;2;FUT	mi¹+ɁmaɁ¹³	mi¹+ɁmaɁ
dsiog¹²	V;IRR;2;FUT	dsiog³	dsiog³
mi²+hog¹²	V;IRR;2;FUT	mi¹+hog³	mi¹+hog³
ɁløaɁ¹²	V;IRR;2;FUT	ɁløaɁ³	ɁløaɁ³
chiínɁ²	V;IRR;2;FUT	hmaɁ³	hmaɁ³¹
dsúgɁ¹²	V;IRR;2;FUT	dsugɁ¹	dsugɁ¹
mi²+dsiúg²	V;IRR;2;FUT	mi¹+dsiug³	mi¹+dsiu
ɁóɁ¹²	V;IRR;2;FUT	ɁuanɁ¹³	ɁoɁ³Ɂ
mi²+tián² (dsǿa¹²)	V;IRR;2;FUT	mi¹+tian³	mi¹+tian³³¹((
mi²+Ɂog¹³	V;IRR;2;FUT	mi¹+Ɂog³	mi¹+Ɂog³
dsiánɁ²	V;IRR;2;FUT	dsianɁ³	dsianɁ
lēɁ²	V;IRR;2;FUT	lēɁ³	lēɁ³³
kuú²	V;IRR;2;FUT	kuu³	kuu³³
kon¹²	V;IRR;2;FUT	kon¹	kon¹³
bḗn²	V;IRR;2;FUT	bēn¹³	bēn¹³
mi²+hlēnɁ¹	V;IRR;2;FUT	mi¹+hlēnɁ³	mi¹+hlēn
hmo¹²	V;IRR;2;FUT	hmo³	hmo³³
tei¹²	V;IRR;2;FUT	tei³	tei³³
huánɁ¹²	V;IRR;2;FUT	huanɁ¹²	huanɁ³
rang¹²	V;IRR;2;FUT	rang³	rang³²
hínɁ¹²	V;IRR;2;FUT	hinɁ³	hinɁ³³
ɁmíɁ²	V;IRR;2;FUT	ɁmiɁ³	ɁmiɁ³
hiég²	V;IRR;2;FUT	hieg¹³	hieg¹
Ɂēn¹²	V;IRR;2;FUT	Ɂēn¹³	Ɂēn³³
kánɁ²	V;IRR;2;FUT	kanɁ¹³	kanɁ¹
gḗɁ²	V;IRR;2;FUT	gēɁ²	gēɁ¹³
ɁagɁ²	V;IRR;2;FUT	ɁagɁ³	ɁagɁ³
ɁmiɁ¹²	V;IRR;2;FUT	ɁmiɁ³	ɁmiɁ³³
háng¹²	V;IRR;2;FUT	hang³	hang³³
nung²	V;IRR;2;FUT	nung¹³	nung¹
kḗn²	V;IRR;2;FUT	kien²	kēn¹³
ton²	V;IRR;2;FUT	ton²	ton¹³
iaɁ¹²	V;IRR;2;FUT	iaɁ³	iaɁ³³
u²+Ɂai¹²	V;IRR;2;FUT	u¹+Ɂai¹	u¹+Ɂai¹
ngo²	V;IRR;2;FUT	ngo¹	ngo³²
chi²+ngiú²	V;IRR;2;FUT	chi¹+ngiu³	chi¹+ngi
hug²	V;IRR;2;FUT	hiug¹	hug¹³
lø²+liugɁ³	V;IRR;2;FUT	lø¹+liugɁ³	lø¹+liug
kiúɁ¹²	V;IRR;2;FUT	kiuɁ³	kiuɁ³³
guiágɁ¹²	V;IPFV;3;PRS	guiágɁ¹²	guiágɁ¹
bø²+hmé²	V;IPFV;3;PRS	bø²+hmé²	bø²+hmé
ɁnóɁ¹² dsí²	V;IPFV;3;PRS	ɁnóɁ¹²	ɁnóɁ¹²²a²
dsánɁ¹²	V;IPFV;3;PRS	dsánɁ¹²	dsánɁ¹²
Ɂuø¹²	V;IPFV;3;PRS	Ɂuø¹²	Ɂuø¹²
guión²	V;IPFV;3;PRS	guión²	guión²
lǿɁ²	V;IPFV;3;PRS	lǿɁ²	lǿɁ²¹
tií²	V;IPFV;3;PRS	tií²	tií²²
guiénɁ²	V;IPFV;3;PRS	guiénɁ²	guiénɁ²
héinɁ¹²	V;IPFV;3;PRS	héinɁ¹²	héinɁ¹²
hénɁ²	V;IPFV;3;PRS	hénɁ²	hénɁ²
hǿɁ¹²	V;IPFV;3;PRS	hǿɁ¹²	hǿɁ¹²
chi²+dsán²	V;IPFV;3;PRS	chi²+dsán²	chi²+dsá
guieɁ¹²	V;IPFV;3;PRS	guieɁ¹²	guieɁ¹²
guiúg²	V;IPFV;3;PRS	guiúg²	guiúg²
Ɂon¹²	V;IPFV;3;PRS	Ɂon¹²	Ɂon¹²
niá¹²	V;IPFV;3;PRS	niá¹²	niá¹²
Ɂan¹²	V;IPFV;3;PRS	Ɂan¹²	Ɂan¹²
heinɁ²	V;IPFV;3;PRS	heinɁ²	heinɁ²
tsanɁ¹²	V;IPFV;3;PRS	tsanɁ¹²	tsanɁ¹²
tánɁ¹²	V;IPFV;3;PRS	tánɁ¹²	tánɁ¹²
kuøin¹²	V;IPFV;3;PRS	kuøin¹²	kuøin¹²
gógɁ¹²	V;IPFV;3;PRS	gógɁ¹²	gógɁ¹²
ɁuáiɁ¹²	V;IPFV;3;PRS	ɁuáiɁ¹²	ɁuáiɁ¹²
mi²+kiíngɁ²	V;IPFV;3;PRS	mi²+kiíngɁ²	mi²+kiíng
tieɁ¹²	V;IPFV;3;PRS	tieɁ¹²	tieɁ¹²
hiúg²	V;IPFV;3;PRS	hiúg²	hiúg²
chio¹²	V;IPFV;3;PRS	chio¹²	chio¹²
tian¹²	V;IPFV;3;PRS	tian¹²	tian¹²
mi²+hmḗ²	V;IPFV;3;PRS	mi²+hmḗ²	mi²+hmḗ
ngē¹²	V;IPFV;3;PRS	ngē¹²	ngē¹²
lanɁ¹²	V;IPFV;3;PRS	lanɁ¹²	lanɁ¹²
ngái¹²	V;IPFV;3;PRS	ngái¹²	ngái¹²
tión²	V;IPFV;3;PRS	tión²	tión²
Ɂøa¹²	V;IPFV;3;PRS	Ɂøa¹²	Ɂøa¹²
hngiáɁ²	V;IPFV;3;PRS	hngiáɁ²	hngiáɁ²
ngioɁ¹²	V;IPFV;3;PRS	ngioɁ¹²	ngioɁ¹²
ɁlianɁ²	V;IPFV;3;PRS	ɁlianɁ²	ɁlianɁ²
køɁ¹²	V;IPFV;3;PRS	køɁ¹²	køɁ¹²
se¹²	V;IPFV;3;PRS	se¹²	se¹²³
tsǿɁ¹²	V;IPFV;3;PRS	tsǿɁ¹²	tsǿɁ¹²
guiú²	V;IPFV;3;PRS	guiú²	guiú²
ta¹²	V;IPFV;3;PRS	ta¹²	ta¹²³
rónɁ¹²	V;IPFV;3;PRS	rónɁ¹²	rónɁ¹²
ha²+Ɂan³	V;IPFV;3;PRS	ha²+Ɂan³	ha²+Ɂan
kágɁ¹²	V;IPFV;3;PRS	kágɁ¹²	kágɁ¹²
guái²	V;IPFV;3;PRS	guái²	guái²
hḗnɁ²	V;IPFV;3;PRS	hḗnɁ²	hḗnɁ²
mi²+hnia¹²	V;IPFV;3;PRS	mi²+hnia¹²	mi²+hnia
hian¹²	V;IPFV;3;PRS	hian¹²	hian¹²
téiɁ¹²	V;IPFV;3;PRS	téiɁ¹²	téiɁ¹²
tsog¹²	V;IPFV;3;PRS	tsog¹²	tsog¹²
hnḗɁ²	V;IPFV;3;PRS	hnḗɁ²	hnḗɁ²
ɁóɁ²	V;IPFV;3;PRS	ɁóɁ²	ɁóɁ²¹
mi²+dsēn¹²	V;IPFV;3;PRS	mi²+dsēn¹²	mi²+dsēn
uénɁ²	V;IPFV;3;PRS	uénɁ²	uénɁ²
rón²	V;IPFV;3;PRS	rón²	rón²²
hǿɁ²	V;IPFV;3;PRS	hǿɁ²	hǿɁ²²
hnǿ²	V;IPFV;3;PRS	hnǿ²	hnǿ²²
hnaiɁ¹²	V;IPFV;3;PRS	hnaiɁ¹²	hnaiɁ¹²
tai²	V;IPFV;3;PRS	tai²	tai²²
mi²+tan¹³	V;IPFV;3;PRS	mi²+tan¹³	mi²+tan¹
ɁuǿɁ¹²	V;IPFV;3;PRS	ɁuǿɁ¹²	ɁuǿɁ¹²
guønɁ¹²	V;IPFV;3;PRS	guønɁ¹²	guønɁ¹²
kán²	V;IPFV;3;PRS	kán²	kán²²
háinɁ¹²	V;IPFV;3;PRS	háinɁ¹²	háinɁ¹²
lag²	V;IPFV;3;PRS	lag²	lag²¹
kiúgɁ²	V;IPFV;3;PRS	kiúgɁ²	kiúgɁ²
bán²	V;IPFV;3;PRS	bán²	bán²¹
guøn¹²	V;IPFV;3;PRS	guøn¹²	guøn¹²
ha²	V;IPFV;3;PRS	ha²	ha²¹
len¹²	V;IPFV;3;PRS	len¹²	len¹²
rǿnɁ¹²	V;IPFV;3;PRS	rǿnɁ¹²	rǿnɁ¹²
gog²	V;IPFV;3;PRS	gog²	gog²²
lán¹²	V;IPFV;3;PRS	lán¹²	lán¹²
niá²	V;IPFV;3;PRS	niá²	niá²²
Ɂna²	V;IPFV;3;PRS	Ɂna²	Ɂna²²
Ɂno¹²	V;IPFV;3;PRS	Ɂno¹²	Ɂno¹²
chióɁ¹²	V;IPFV;3;PRS	chióɁ¹²	chióɁ¹²
guiónɁ²	V;IPFV;3;PRS	guiónɁ²	guiónɁ²
mi²+kon¹²	V;IPFV;3;PRS	mi²+kon¹²	mi²+kon¹
méɁ²	V;IPFV;3;PRS	méɁ²	méɁ²³
ngié²	V;IPFV;3;PRS	ngié²	ngié²
tsogɁ² hmøi²	V;IPFV;3;PRS	tsogɁ²	tsogɁ²²n²³
ɁnáiɁ¹²	V;IPFV;3;PRS	ɁnáiɁ¹²	ɁnáiɁ¹²
ténɁ¹²	V;IPFV;3;PRS	ténɁ¹²	ténɁ¹²
guǿn¹²	V;IPFV;3;PRS	guǿn¹²	guǿn¹²
tán¹²	V;IPFV;3;PRS	tán¹²	tán¹²
tson²	V;IPFV;3;PRS	tson²	tson²
hen¹²	V;IPFV;3;PRS	hen¹²	hen¹²
hián²	V;IPFV;3;PRS	hián²	hián²
tsón¹²	V;IPFV;3;PRS	tsón¹²	tsón¹²
kii²+túg²	V;IPFV;3;PRS	kii²+túg²	kii²+túg
kii²+tág¹²	V;IPFV;3;PRS	kii²+tág¹²	kii²+tág
hngia¹²	V;IPFV;3;PRS	hngia¹²	hngia¹²
dsoɁ²	V;IPFV;3;PRS	dsoɁ²	dsoɁ²
Ɂán²	V;IPFV;3;PRS	Ɂán²	Ɂán²²
Ɂiog²	V;IPFV;3;PRS	Ɂiog²	Ɂiog²
tsog²	V;IPFV;3;PRS	tsog²	tsog²
tsǿaɁ¹²	V;IPFV;3;PRS	tsǿaɁ¹²	tsǿaɁ¹²
hne¹²	V;IPFV;3;PRS	hne¹²	hne¹²
ɁioɁ¹²	V;IPFV;3;PRS	ɁioɁ¹²	ɁioɁ¹²
tsǿng²	V;IPFV;3;PRS	tsǿng²	tsǿng²
ku²+hmáɁ²	V;IPFV;3;PRS	ku²+hmáɁ²	ku²+hmáɁ
hág¹²	V;IPFV;3;PRS	hág¹²	hág¹²
nēɁ¹²	V;IPFV;3;PRS	nēɁ¹²	nēɁ¹²
húɁ²	V;IPFV;3;PRS	húɁ²	húɁ²²
mi²+dsiog¹	V;IPFV;3;PRS	mi²+dsiog¹	mi²+dsio
huɁ¹²	V;IPFV;3;PRS	huɁ¹²	huɁ¹²
héin¹²	V;IPFV;3;PRS	héin¹²	héin¹²
hleɁ¹²	V;IPFV;3;PRS	hleɁ¹²	hleɁ¹²
dsúgɁ²	V;IPFV;3;PRS	dsúgɁ²	dsúgɁ²
ngie¹²	V;IPFV;3;PRS	ngie¹²	ngie¹²
dsiánɁ¹²	V;IPFV;3;PRS	dsiánɁ¹²	dsiánɁ¹
Ɂiag²	V;IPFV;3;PRS	Ɂiag²	Ɂiag²
kieg²	V;IPFV;3;PRS	kieg²	kieg²
mi²+tan¹²	V;IPFV;3;PRS	mi²+tan¹²	mi²+tan¹
køin²	V;IPFV;3;PRS	køin²	køin²
chiáng¹²	V;IPFV;3;PRS	chiáng¹²	chiáng¹
kióɁ¹²	V;IPFV;3;PRS	kióɁ¹²	kióɁ¹²
Ɂlúg²	V;IPFV;3;PRS	Ɂlúg²	Ɂlúg²
gǿaɁ¹²	V;IPFV;3;PRS	gǿaɁ¹²	gǿaɁ¹²
guen²	V;IPFV;3;PRS	guen²	guen²
tug	V;IPFV;3;PRS	tug¹²	tug¹
hmǿɁ¹²	V;IPFV;3;PRS	hmǿɁ¹²	hmǿɁ¹²
dsie¹²	V;IPFV;3;PRS	dsie¹²	dsie¹²
tsénɁ²	V;IPFV;3;PRS	tsénɁ²	tsénɁ²
chiunɁ¹²	V;IPFV;3;PRS	chiunɁ¹²	chiunɁ¹
Ɂméi¹²	V;IPFV;3;PRS	Ɂméi¹²	Ɂméi¹²
tióɁ¹²	V;IPFV;3;PRS	tióɁ¹²	tióɁ¹²
kug²	V;IPFV;3;PRS	kug²	kug²²
tsēn¹²	V;IPFV;3;PRS	tsēn¹²	tsēn¹²
niúɁ²	V;IPFV;3;PRS	niúɁ²	niúɁ²
dsen³ (kaɁ³)	V;IPFV;3;PRS	dsen³	dsen³u¹²Ɂ¹
chiogɁ¹²	V;IPFV;3;PRS	chiogɁ¹²	chiogɁ¹
chi²+lánɁ²	V;IPFV;3;PRS	chi²+lánɁ²	chi²+lán
Ɂén²	V;IPFV;3;PRS	Ɂén²	Ɂén²²
hánɁ²	V;IPFV;3;PRS	hánɁ²	hánɁ²
tsø²+kuønɁ¹²	V;IPFV;3;PRS	tsø²+kuønɁ¹²	tsø²+kuønɁ
uǿi²	V;IPFV;3;PRS	uǿi²	uǿi²²
mi²+kuuɁ¹²	V;IPFV;3;PRS	mi²+kuuɁ¹²	mi²+kuuɁ
tø²+gugɁ¹²	V;IPFV;3;PRS	tø²+gugɁ¹²	tø²+gugɁ
mi²+hlíɁ²	V;IPFV;3;PRS	mi²+hlíɁ²	mi²+hlíɁ
búɁ²	V;IPFV;3;PRS	búɁ²	búɁ²¹
køɁ³ (hmai³)	V;IPFV;3;PRS	køɁ³	køɁ³³a²g¹n
Ɂiei¹²	V;IPFV;3;PRS	Ɂiei¹²	Ɂiei¹²
dsa²	V;IPFV;3;PRS	dsa²	dsa²²
kién¹²	V;IPFV;3;PRS	kién¹²	kién¹²
hḗn²	V;IPFV;3;PRS	hḗn²	hḗn²²
ngai¹²	V;IPFV;3;PRS	ngai¹²	ngai¹²
mi²+hngió¹	V;IPFV;3;PRS	mi²+hngió¹	mi²+hngi
chión²	V;IPFV;3;PRS	chión²	chión²
guianɁ¹²	V;IPFV;3;PRS	guianɁ²	guianɁ¹
hmḗɁ²	V;IPFV;3;PRS	hmḗɁ²	hmḗɁ²
dsø²+togɁ¹²	V;IPFV;3;PRS	dsø²+togɁ¹²	dsø²+togɁ
mi²+dsíg²	V;IPFV;3;PRS	mi²+dsíg²	mi²+dsíg
ngøɁ¹²	V;IPFV;3;PRS	ngøɁ¹²	ngøɁ¹²
huúɁ²	V;IPFV;3;PRS	huúɁ²	huúɁ²
lieɁ¹²	V;IPFV;3;PRS	lieɁ¹²	lieɁ¹²
ɁiéiɁ¹²	V;IPFV;3;PRS	ɁiéiɁ¹²	ɁiéiɁ¹²
chiag¹²	V;IPFV;3;PRS	chiag¹²	chiag¹²
káiɁ¹²	V;IPFV;3;PRS	káiɁ¹²	káiɁ¹²
chi²+hné¹	V;IPFV;3;PRS	chi²+hné¹	chi²+hné
guen¹²	V;IPFV;3;PRS	guen¹²	guen¹²
mi²+hǿ²	V;IPFV;3;PRS	mi²+hǿ²	mi²+hǿ²
hmáɁ² (dsǿa¹²)	V;IPFV;3;PRS	hmáɁ²	hmáɁ²²¹²¹²³
tónɁ² (huu¹²)	V;IPFV;3;PRS	tónɁ²	tónɁ²n¹²á¹
tanɁ²	V;IPFV;3;PRS	tanɁ²	tanɁ²
hogɁ¹²	V;IPFV;3;PRS	hogɁ¹²	hogɁ¹²
mi²+kánɁ²	V;IPFV;3;PRS	mi²+kánɁ²	mi²+kánɁ
Ɂuan¹²	V;IPFV;3;PRS	Ɂuan¹²	Ɂuan¹²
li²	V;IPFV;3;PRS	li²	li²²
kēnɁ¹²	V;IPFV;3;PRS	kēnɁ¹²	kēnɁ¹²
dsióɁ¹²	V;IPFV;3;PRS	dsióɁ¹²	dsióɁ¹²
tsiɁ¹²	V;IPFV;3;PRS	tsiɁ¹²	tsiɁ¹²
hlái²	V;IPFV;3;PRS	hlái²	hlái²
héɁ²	V;IPFV;3;PRS	héɁ²	héɁ²¹
ɁnióɁ¹²	V;IPFV;3;PRS	ɁnióɁ¹²	ɁnióɁ¹²
ngiú²	V;IPFV;3;PRS	ngiú²	ngiú²
tag¹²	V;IPFV;3;PRS	tag¹²	tag¹²
ɁiánɁ²	V;IPFV;3;PRS	ɁiánɁ²	ɁiánɁ²
mi²+Ɂai¹	V;IPFV;3;PRS	mi²+Ɂai¹	mi²+Ɂai
kǿ²	V;IPFV;3;PRS	kǿ²	kǿ²¹
tsí¹²	V;IPFV;3;PRS	tsí¹²	tsí¹²
lan¹²	V;IPFV;3;PRS	lan¹²	lan¹²
kiog¹²	V;IPFV;3;PRS	kiog¹²	kiog¹²
chi²+dsén²	V;IPFV;3;PRS	chi²+dsén²	chi²+dsé
hlán²	V;IPFV;3;PRS	hlán²	hlán²
u¹+lén²	V;IPFV;3;PRS	u²+lén²	u²+lén²
tsen¹²	V;IPFV;3;PRS	tsen¹²	tsen¹²
dsan²	V;IPFV;3;PRS	dsan²	dsan²
ɁónɁ²	V;IPFV;3;PRS	ɁónɁ²	ɁónɁ²
hliúg² (lag³ dsi³)	V;IPFV;3;PRS	hliúg²	hliúg²úg¹Ɂ¹²(
hmáɁ² (ta³)	V;IPFV;3;PRS	hmáɁ²	hmáɁ²u¹²Ɂ
tiun¹²	V;IPFV;3;PRS	tiun¹²	tiun¹²
lø²+liúɁ²	V;IPFV;3;PRS	lø²+liúɁ²	lø²+liúɁ
dsǿɁ²	V;IPFV;3;PRS	dsǿɁ²	dsǿɁ²
ha¹²	V;IPFV;3;PRS	ha¹²	ha¹²³
guian¹²	V;IPFV;3;PRS	guian¹²	guian¹²
ti²+li¹	V;IPFV;3;PRS	ti²+li¹	ti²+li¹
mi²+ngḗɁ¹	V;IPFV;3;PRS	mi²+ngḗɁ¹	mi²+ngḗɁ
Ɂien²	V;IPFV;3;PRS	Ɂien²	Ɂien²
guiúnɁ¹²	V;IPFV;3;PRS	guiúnɁ¹²	guiúnɁ¹
mi²+kuen¹²	V;IPFV;3;PRS	mi²+kuen¹²	mi²+kuen
hliánɁ²	V;IPFV;3;PRS	hliánɁ²	hliánɁ²
mi²+gǿg¹	V;IPFV;3;PRS	mi²+gǿg¹	mi²+gǿg
Ɂmǿi²	V;IPFV;3;PRS	Ɂmǿi²	Ɂmǿi²
hnó²	V;IPFV;3;PRS	hnó²	hnó²²
ti²+dsiog¹	V;IPFV;3;PRS	ti²+dsiog¹	ti²+dsio
Ɂǿng²	V;IPFV;3;PRS	Ɂǿng²	Ɂǿng²
Ɂnē¹²	V;IPFV;3;PRS	Ɂnē¹²	Ɂnē¹²
Ɂngieng¹²	V;IPFV;3;PRS	Ɂngieng¹²	Ɂngieng¹
hlég²	V;IPFV;3;PRS	hlég²	hlég²
hné¹²	V;IPFV;3;PRS	hné¹²	hné¹²
gǿi¹²	V;IPFV;3;PRS	gǿi¹²	gǿi¹²
chiog¹²	V;IPFV;3;PRS	chiog¹²	chiog¹²
húgɁ²	V;IPFV;3;PRS	húgɁ²	húgɁ²
mái¹²	V;IPFV;3;PRS	mái¹²	mái¹²
kiáɁ²	V;IPFV;3;PRS	kiáɁ²	kiáɁ²
dsogɁ¹²	V;IPFV;3;PRS	dsogɁ¹²	dsogɁ¹²
kií¹²	V;IPFV;3;PRS	kií¹²	kií¹²
kian¹²	V;IPFV;3;PRS	kian¹²	kian¹²
tián²	V;IPFV;3;PRS	tián²	tián²
ɁnáɁ¹²	V;IPFV;3;PRS	ɁnáɁ¹²	ɁnáɁ¹²
tso¹²	V;IPFV;3;PRS	tso¹²	tso¹²
siég²	V;IPFV;3;PRS	siég²	siég²
nió²	V;IPFV;3;PRS	nió²	nió²¹
kien¹²	V;IPFV;3;PRS	kien¹²	kien¹²
tsén²	V;IPFV;3;PRS	tsén²	tsén²
Ɂuu²	V;IPFV;3;PRS	Ɂuu²	Ɂuu²²
búɁ¹²	V;IPFV;3;PRS	búɁ¹²	búɁ¹²
Ɂuan²	V;IPFV;3;PRS	Ɂuan²	Ɂuan²
ngēɁ² dsǿa¹²	V;IPFV;3;PRS	ngēɁ²	ngēɁ²²²²ɁɁ
mi²+guionɁ¹	V;IPFV;3;PRS	mi²+guionɁ¹	mi²+guion
tagɁ²	V;IPFV;3;PRS	tagɁ²	tagɁ²
kúgɁ²	V;IPFV;3;PRS	kúgɁ²	kúgɁ²
Ɂma¹²	V;IPFV;3;PRS	Ɂma¹²	Ɂma¹²
chiágɁ¹²	V;IPFV;3;PRS	chiágɁ¹²	chiágɁ¹
tø²+kanɁ¹³	V;IPFV;3;PRS	tø²+kanɁ¹³	tø²+kanɁ
hiégɁ¹²	V;IPFV;3;PRS	hiégɁ¹²	hiégɁ¹²
ngáɁ¹²	V;IPFV;3;PRS	ngáɁ¹²	ngáɁ¹²
ɁiúɁ²	V;IPFV;3;PRS	ɁiúɁ²	ɁiúɁ²
mi²+Ɂliúg²	V;IPFV;3;PRS	mi²+Ɂliúg²	mi²+Ɂliú
mi²+dsií¹	V;IPFV;3;PRS	mi²+dsií¹	mi²+dsií
tóɁ¹²	V;IPFV;3;PRS	tóɁ¹²	tóɁ¹²
tanɁ¹² huu¹²	V;IPFV;3;PRS	tanɁ¹²	tanɁ¹²o¹²Ɂ
kán² guiing²	V;IPFV;3;PRS	kán²	kán²¹²gión
Ɂug¹²	V;IPFV;3;PRS	Ɂug¹²	Ɂug¹²
hái¹²	V;IPFV;3;PRS	hái¹²	hái¹²
ián²	V;IPFV;3;PRS	ián²	ián²²
hén²	V;IPFV;3;PRS	hén²	hén²²
mi²+Ɂan¹²	V;IPFV;3;PRS	mi²+Ɂan¹²	mi²+Ɂan¹
hngieng¹²	V;IPFV;3;PRS	hngieng²	hngieng²
pø²+hánɁ²	V;IPFV;3;PRS	pø²+hánɁ²	pø²+hánɁ
Ɂø²+tsúgɁ²	V;IPFV;3;PRS	Ɂø²+tsúgɁ²	Ɂø²+tsúg
hngii²	V;IPFV;3;PRS	hngii²	hngii²
ɁaiɁ²	V;IPFV;3;PRS	ɁaiɁ²	ɁaiɁ²
Ɂéi¹²	V;IPFV;3;PRS	Ɂéi¹²	Ɂéi¹²
ié²	V;IPFV;3;PRS	ié²	ié²²
hønɁ¹²	V;IPFV;3;PRS	hønɁ¹²	hønɁ¹²
tsøi¹²	V;IPFV;3;PRS	tsøi¹²	tsøi¹²
kuǿɁ¹²	V;IPFV;3;PRS	kuǿɁ¹²	kuǿɁ¹²
Ɂuǿi²	V;IPFV;3;PRS	Ɂuǿi²	Ɂuǿi²
taɁ²	V;IPFV;3;PRS	taɁ²	taɁ²³
tiánɁ¹²	V;IPFV;3;PRS	tiánɁ¹²	tiánɁ¹²
tsenɁ¹²	V;IPFV;3;PRS	tsenɁ¹²	tsenɁ¹²
ɁǿnɁ²	V;IPFV;3;PRS	ɁǿnɁ²	ɁǿnɁ²
Ɂe¹²	V;IPFV;3;PRS	Ɂe¹²	Ɂe¹²³
ngó¹²	V;IPFV;3;PRS	ngó¹²	ngó¹²
chiángɁ¹²	V;IPFV;3;PRS	chiángɁ¹²	chiángɁ¹
mē¹²	V;IPFV;3;PRS	mē¹²	mē¹²²
mi²+kiónɁ²	V;IPFV;3;PRS	mi²+kiónɁ²	mi²+kión
kiagɁ¹²	V;IPFV;3;PRS	kiagɁ¹²	kiagɁ¹²
ɁmóɁ²	V;IPFV;3;PRS	ɁmóɁ²	ɁmóɁ²
hniang²	V;IPFV;3;PRS	hniang²	hniang²
sián²	V;IPFV;3;PRS	sián²	sián²
dsii²+lei¹	V;IPFV;3;PRS	dsii²+lei¹	dsii²+le
mi²+kán¹²	V;IPFV;3;PRS	mi²+kán¹²	mi²+kán¹
guiugɁ²	V;IPFV;3;PRS	guiugɁ²	guiugɁ²
mi²+hní¹	V;IPFV;3;PRS	mi²+hní¹	mi²+hní
nié¹²	V;IPFV;3;PRS	nié¹²	nié¹²
ɁenɁ¹²	V;IPFV;3;PRS	ɁenɁ¹²	ɁenɁ¹²
Ɂig²	V;IPFV;3;PRS	Ɂig²	Ɂig²²
tsēnɁ¹²	V;IPFV;3;PRS	tsēnɁ¹²	tsēnɁ¹²
mḗɁ²	V;IPFV;3;PRS	mḗɁ²	mḗɁ²³
kang²	V;IPFV;3;PRS	kang²	kang²
ngǿi²	V;IPFV;3;PRS	ngǿi²	ngǿi²
hḗɁ²	V;IPFV;3;PRS	hḗɁ²	hḗɁ²¹
kø²+hinɁ¹²	V;IPFV;3;PRS	kø²+hinɁ¹²	kø²+hinɁ
siógɁ¹²	V;IPFV;3;PRS	siógɁ¹²	siógɁ¹²
hénɁ¹²	V;IPFV;3;PRS	hénɁ¹²	hénɁ¹²
ti²+kḗn¹	V;IPFV;3;PRS	ti²+kḗn¹	ti²+kḗn
siúgɁ²	V;IPFV;3;PRS	siúgɁ²	siúgɁ²
hnáɁ¹²	V;IPFV;3;PRS	hnáɁ¹²	hnáɁ¹²
Ɂnie¹²	V;IPFV;3;PRS	Ɂnie¹²	Ɂnie¹²
ngie³	V;IPFV;3;PRS	ngie¹²	ngie³
ngieɁ¹³	V;IPFV;3;PRS	ngieɁ¹³	ngieɁ¹³
tsøg²	V;IPFV;3;PRS	tsøg²	tsøg²
kón²	V;IPFV;3;PRS	kón²	kón²²
dságɁ¹²	V;IPFV;3;PRS	dságɁ¹²	dságɁ¹²
Ɂian²	V;IPFV;3;PRS	Ɂian²	Ɂian²
Ɂnai¹²	V;IPFV;3;PRS	Ɂnai¹²	Ɂnai¹²
guienɁ¹²	V;IPFV;3;PRS	guienɁ¹²	guienɁ¹
hngió²	V;IPFV;3;PRS	hngió²	hngió²
kiugɁ²	V;IPFV;3;PRS	kiugɁ²	kiugɁ²
chióg¹²	V;IPFV;3;PRS	chióg¹²	chióg¹²
Ɂme¹²	V;IPFV;3;PRS	Ɂme¹²	Ɂme¹²
Ɂé²	V;IPFV;3;PRS	Ɂé²	Ɂé²¹
Ɂmóng¹²	V;IPFV;3;PRS	Ɂmóng¹²	Ɂmóng¹²
Ɂog¹²	V;IPFV;3;PRS	Ɂog¹²	Ɂog¹²
Ɂia¹²	V;IPFV;3;PRS	Ɂia¹²	Ɂia¹²
u¹+lian¹	V;IPFV;3;PRS	u²+lian¹	u²+lian
bø²+lḗnɁ²	V;IPFV;3;PRS	bø²+lḗnɁ²	bø²+lḗnɁ
tø²+dsḗn³	V;IPFV;3;PRS	tø²+dsḗn³	tø²+dsḗn
kēn²	V;IPFV;3;PRS	kēn¹²	kēn²²
kiang¹²	V;IPFV;3;PRS	kiang¹²	kiang¹²
chiúg²	V;IPFV;3;PRS	chiúg²	chiúg²
ɁánɁ²	V;IPFV;3;PRS	ɁánɁ²	ɁánɁ²
ɁlanɁ¹²	V;IPFV;3;PRS	ɁlanɁ¹²	ɁlanɁ¹²
tiúg²	V;IPFV;3;PRS	tiúg²	tiúg²
guu²+dsḗn¹³	V;IPFV;3;PRS	guu²+dsḗn¹³	guu²+dsḗn
guiánɁ¹²	V;IPFV;3;PRS	guiánɁ¹²	guiánɁ¹
Ɂein¹³	V;IPFV;3;PRS	Ɂein¹³	Ɂein¹³
hniá¹²	V;IPFV;3;PRS	hniá¹²	hniá¹²
hlíɁ¹²	V;IPFV;3;PRS	hlíɁ¹²	hlíɁ¹²
séi²	V;IPFV;3;PRS	séi²	séi²²
Ɂlan¹²	V;IPFV;3;PRS	Ɂlan¹²	Ɂlan¹²
ngoɁ³	V;IPFV;3;PRS	ngoɁ³	ngoɁ³
rain¹²	V;IPFV;3;PRS	rain¹²	rain¹²
hog¹²	V;IPFV;3;PRS	hog¹²	hog¹²
lan²	V;IPFV;3;PRS	lan²	lan²²
ɁénɁ¹²	V;IPFV;3;PRS	ɁénɁ¹²	ɁénɁ¹²
tsá¹²	V;IPFV;3;PRS	tsá¹²	tsá¹²
guiang¹²	V;IPFV;3;PRS	guiang¹²	guiang¹
kuan¹²	V;IPFV;3;PRS	kuan¹²	kuan¹²
Ɂngiéng²	V;IPFV;3;PRS	Ɂngiéng²	Ɂngiéng
siog²	V;IPFV;3;PRS	siog²	siog²
gúgɁ¹² dsǿa¹²	V;IPFV;3;PRS	gúgɁ¹²	gúgɁ¹²²¹²²
huu¹²	V;IPFV;3;PRS	huu¹²	huu¹²
tsíɁ¹²	V;IPFV;3;PRS	tsíɁ¹²	tsíɁ¹²
hí²	V;IPFV;3;PRS	hí²	hí²¹
Ɂéng²	V;IPFV;3;PRS	Ɂéng²	Ɂéng²
tan¹³	V;IPFV;3;PRS	tan¹³	tan¹³
hnóɁ²	V;IPFV;3;PRS	hnóɁ²	hnóɁ²
ku²+guénɁ²	V;IPFV;3;PRS	ku²+guénɁ²	ku²+guén
hnéi¹²	V;IPFV;3;PRS	hnéi¹²	hnéi¹²
Ɂán¹² ɁogɁ¹²	V;IPFV;3;PRS	Ɂán¹²	Ɂán¹²n¹i³¹
gúɁ¹²	V;IPFV;3;PRS	gúɁ¹²	gúɁ¹²
kánɁ¹²	V;IPFV;3;PRS	kánɁ¹²	kánɁ¹²
kionɁ¹²	V;IPFV;3;PRS	kionɁ¹²	kionɁ¹²
bēn¹²	V;IPFV;3;PRS	bēn¹²	bēn¹²
dsi²	V;IPFV;3;PRS	dsi²	dsi²²
mi²+dsiagɁ¹	V;IPFV;3;PRS	mi²+dsiagɁ¹	mi²+dsiag
chionɁ¹²	V;IPFV;3;PRS	chionɁ¹²	chionɁ¹
ngēɁ²	V;IPFV;3;PRS	ngēɁ²	ngēɁ²
mi²+lei¹³	V;IPFV;3;PRS	mi²+lei¹³	mi²+lei¹
tógɁ¹²	V;IPFV;3;PRS	tógɁ¹²	tógɁ¹²
mi²+liág¹	V;IPFV;3;PRS	mi²+liág¹	mi²+liág
guuɁ¹²	V;IPFV;3;PRS	guuɁ¹²	guuɁ¹²
ɁlianɁ¹²	V;IPFV;3;PRS	ɁlianɁ¹²	ɁlianɁ¹
neɁ¹²	V;IPFV;3;PRS	neɁ¹²	neɁ¹²
mi²+gag¹²	V;IPFV;3;PRS	mi²+gag¹²	mi²+gag¹
høn¹²	V;IPFV;3;PRS	høn¹²	høn¹²
hógɁ¹²	V;IPFV;3;PRS	hógɁ¹²	hógɁ¹²
kieng¹²	V;IPFV;3;PRS	kieng¹²	kieng¹²
mi²+dsē¹²	V;IPFV;3;PRS	mi²+dsē¹²	mi²+dsē¹
tei²	V;IPFV;3;PRS	tei²	tei²²
kuø¹²	V;IPFV;3;PRS	kuø¹²	kuø¹²
kián²	V;IPFV;3;PRS	kián²	kián²
hiúɁ²	V;IPFV;3;PRS	hiúɁ²	hiúɁ²
dsén²	V;IPFV;3;PRS	dsén²	dsén²
mi²+huanɁ¹²	V;IPFV;3;PRS	mi²+huanɁ¹²	mi²+huanɁ
hlíɁ²	V;IPFV;3;PRS	hlíɁ²	hlíɁ²
kiiɁ²	V;IPFV;3;PRS	kiiɁ²	kiiɁ²
tan¹²	V;IPFV;3;PRS	tan¹²	tan¹²
ko¹²	V;IPFV;3;PRS	ko¹²	ko¹²¹
len¹² dsǿa¹²	V;IPFV;3;PRS	len¹²	len¹²a¹²gɁ
tson¹²	V;IPFV;3;PRS	tson¹²	tson¹²
han¹²	V;IPFV;3;PRS	han¹²	han¹²
Ɂøin¹²	V;IPFV;3;PRS	Ɂøin¹²	Ɂøin¹²
dsióɁ¹² hǿg³	V;IPFV;3;PRS	dsióɁ¹²	dsióɁ¹²²³²
hai¹²	V;IPFV;3;PRS	hai¹²	hai¹²
ngángɁ¹²	V;IPFV;3;PRS	ngángɁ¹²	ngángɁ¹
Ɂen¹³	V;IPFV;3;PRS	Ɂen¹³	Ɂen¹³
siúɁ²	V;IPFV;3;PRS	siúɁ²	siúɁ²
ɁnangɁ²	V;IPFV;3;PRS	ɁnangɁ²	ɁnangɁ²
tion¹²	V;IPFV;3;PRS	tion¹²	tion¹²
ɁáiɁ¹²	V;IPFV;3;PRS	ɁáiɁ¹²	ɁáiɁ¹²
hlénɁ²	V;IPFV;3;PRS	hlénɁ²	hlénɁ²
laiɁ¹²	V;IPFV;3;PRS	laiɁ¹²	laiɁ¹²
nøɁ¹²	V;IPFV;3;PRS	nøɁ¹²	nøɁ¹²
mi²+hngiáng¹	V;IPFV;3;PRS	mi²+hngiáng¹	mi²+hngián
Ɂlí²	V;IPFV;3;PRS	Ɂlí²	Ɂlí²²
ɁlogɁ²	V;IPFV;3;PRS	ɁlogɁ²	ɁlogɁ²
siág¹²	V;IPFV;3;PRS	siág¹²	siág¹²
Ɂlen¹²	V;IPFV;3;PRS	Ɂlen¹²	Ɂlen¹²
dsiog¹²	V;IPFV;3;PRS	dsiog¹²	dsiog¹²
nio²	V;IPFV;3;PRS	nio²	nio²²
kienɁ¹²	V;IPFV;3;PRS	kienɁ¹²	kienɁ¹²
Ɂiá¹²	V;IPFV;3;PRS	Ɂiá¹²	Ɂiá¹²
chiínɁ²	V;IPFV;3;PRS	chiínɁ²	chiínɁ²
ɁniɁ¹²	V;IPFV;3;PRS	ɁniɁ¹²	ɁniɁ¹²
mi²+dsiúg²	V;IPFV;3;PRS	mi²+dsiúg²	mi²+dsiú
hnḗ¹²	V;IPFV;3;PRS	hnḗ¹²	hnḗ¹²
mi²+tián² (dsǿa¹²)	V;IPFV;3;PRS	mi²+tián²	mi²+tián²Ɂ¹²(
tsǿn²	V;IPFV;3;PRS	tsǿn²	tsǿn²
u²+nio¹³	V;IPFV;3;PRS	u²+nio¹³	u²+nio¹
mi²+Ɂog¹³	V;IPFV;3;PRS	mi²+Ɂog¹³	mi²+Ɂog¹
dsiánɁ²	V;IPFV;3;PRS	dsiánɁ²	dsiánɁ²
laɁ¹²	V;IPFV;3;PRS	laɁ¹²	laɁ¹²
øg¹²	V;IPFV;3;PRS	øg¹²	øg¹²h
lēɁ²	V;IPFV;3;PRS	lēɁ²	lēɁ²²
ɁǿɁ¹²	V;IPFV;3;PRS	ɁǿɁ¹²	ɁǿɁ¹²
hngio¹²	V;IPFV;3;PRS	hngio¹²	hngio¹²
tsø²+nióɁ²	V;IPFV;3;PRS	tsø²+nióɁ²	tsø²+nió
mi²+Ɂan¹³	V;IPFV;3;PRS	mi²+Ɂan¹³	mi²+Ɂan¹
siiɁ²	V;IPFV;3;PRS	siiɁ²	siiɁ²
kuú²	V;IPFV;3;PRS	kuú²	kuú²²
iéiɁ¹²	V;IPFV;3;PRS	iéiɁ¹²	iéiɁ¹²
hagɁ²	V;IPFV;3;PRS	hagɁ²	hagɁ²
bá²	V;IPFV;3;PRS	bá²	bá²²
kon¹²	V;IPFV;3;PRS	kon¹²	kon¹²
mi²+hlēnɁ¹	V;IPFV;3;PRS	mi²+hlēnɁ¹	mi²+hlēn
hmo¹²	V;IPFV;3;PRS	hmo¹²	hmo¹²
nei¹²	V;IPFV;3;PRS	nei¹²	nei¹²
tei¹²	V;IPFV;3;PRS	tei¹²	tei¹²
siúgɁ¹²	V;IPFV;3;PRS	siúgɁ¹²	siúgɁ¹²
huánɁ¹²	V;IPFV;3;PRS	huánɁ¹²	huánɁ¹²
ná²	V;IPFV;3;PRS	ná²	ná²²
chiú²	V;IPFV;3;PRS	chiú²	chiú²
ngǿ²	V;IPFV;3;PRS	ngǿ²	ngǿ²²
kǿg²	V;IPFV;3;PRS	kǿg²	kǿg²²
Ɂlǿg²	V;IPFV;3;PRS	Ɂlǿg²	Ɂlǿg²
hngieɁ¹²	V;IPFV;3;PRS	hngieɁ¹²	hngieɁ¹
hínɁ¹²	V;IPFV;3;PRS	hínɁ¹²	hínɁ¹²
hiég²	V;IPFV;3;PRS	hiég²	hiég²
Ɂēn¹²	V;IPFV;3;PRS	Ɂēn¹²	Ɂēn¹²
kánɁ²	V;IPFV;3;PRS	kánɁ²	kánɁ²
ti²+kiín¹	V;IPFV;3;PRS	ti²+kiín¹	ti²+kiín
gḗɁ²	V;IPFV;3;PRS	gḗɁ²	gḗɁ²³
ning²	V;IPFV;3;PRS	ning²	ning²
guiúɁ¹²	V;IPFV;3;PRS	guiúɁ¹²	guiúɁ¹²
kuúɁ²	V;IPFV;3;PRS	kuúɁ²	kuúɁ²
ɁmiɁ¹²	V;IPFV;3;PRS	ɁmiɁ¹²	ɁmiɁ¹²
tøa¹²	V;IPFV;3;PRS	tøa¹²	tøa¹²
háng¹²	V;IPFV;3;PRS	háng¹²	háng¹²
kḗn²	V;IPFV;3;PRS	kḗn²	kḗn²²
nio¹²	V;IPFV;3;PRS	nio¹²	nio¹²
hní²	V;IPFV;3;PRS	hní²	hní²²
kángɁ¹²	V;IPFV;3;PRS	kángɁ¹²	kángɁ¹²
hnái¹²	V;IPFV;3;PRS	hnái¹²	hnái¹²
hniuɁ²	V;IPFV;3;PRS	hniuɁ²	hniuɁ²
há¹²	V;IPFV;3;PRS	há¹²	há¹²¹
héin²	V;IPFV;3;PRS	héin²	héin²
u²+lé²	V;IPFV;3;PRS	u²+lé²	u²+lé²
u²+Ɂai¹²	V;IPFV;3;PRS	u²+Ɂai¹²	u²+Ɂai¹
táiɁ¹²	V;IPFV;3;PRS	táiɁ¹²	táiɁ¹²
chiág¹²	V;IPFV;3;PRS	chiág¹²	chiág¹²
niu¹²	V;IPFV;3;PRS	niu¹²	niu¹²
tiúɁ¹	V;IPFV;3;PRS	tiúɁ¹	tiúɁ¹
køg²	V;IPFV;3;PRS	køg²	køg²²
Ɂa¹²	V;IPFV;3;PRS	Ɂa¹²	Ɂa¹²³
hnøa¹²	V;IPFV;3;PRS	hnøa¹²	hnøa¹²
ha²+rǿng²	V;IPFV;3;PRS	ha²+rǿng²	ha²+rǿng
ɁuøɁ¹²	V;IPFV;3;PRS	ɁuøɁ¹²	ɁuøɁ¹²
rǿng²	V;IPFV;3;PRS	rǿng²	rǿng²
ha²+kién¹³	V;IPFV;3;PRS	ha²+kién¹³	ha²+kién
tsénɁ¹²	V;IPFV;3;PRS	tsénɁ¹²	tsénɁ¹²
lø²+liugɁ³	V;IPFV;3;PRS	lø²+liugɁ³	lø²+liug
ɁḗɁ²	V;IPFV;3;PRS	ɁḗɁ²	ɁḗɁ²¹
dsen¹²	V;IPFV;3;PRS	dsen¹²	dsen¹²
huøi²	V;IPFV;3;PRS	huøi²	huøi²
Ɂii²	V;IPFV;3;PRS	Ɂii²	Ɂii²²
tøng²	V;IPFV;3;PRS	tøng²	tøng²
hǿgɁ²	V;IPFV;3;PRS	hǿgɁ²	hǿgɁ²
niɁ³	V;IPFV;3;PRS	niɁ³	niɁ³¹
siánɁ²	V;IPFV;3;PRS	siánɁ²	siánɁ²
hngǿi²	V;IPFV;3;PRS	hngǿi²	hngǿi²
kǿn²	V;IPFV;3;PRS	kǿn²	kǿn²²
Ɂuøi¹²	V;IPFV;3;PRS	Ɂuøi¹²	Ɂuøi¹²
hnáiɁ²	V;IPFV;3;PRS	hnáiɁ²	hnáiɁ²
røg²	V;IPFV;3;PRS	røg²	røg²¹
guiágɁ¹²	V;IRR;PL;1;FUT	guiagɁ¹²	guiagɁ¹
bø²+hmé²	V;IRR;PL;1;FUT	bø¹+hme³	bø¹+hme
dsánɁ¹²	V;IRR;PL;1;FUT	dsianɁ¹²	dsinɁ¹³
Ɂuø¹²	V;IRR;PL;1;FUT	Ɂuø³	Ɂuø³³
lǿɁ²	V;IRR;PL;1;FUT	liɁ²	løɁ¹³
tií²	V;IRR;PL;1;FUT	tii¹³	tii³¹
guiénɁ²	V;IRR;PL;1;FUT	guienɁ¹³	guienɁ¹
héinɁ¹²	V;IRR;PL;1;FUT	heinɁ³	heinɁ³³
mi²+kionɁ¹	V;IRR;PL;1;FUT	mi¹+kionɁ¹³	mi¹+kion
hénɁ²	V;IRR;PL;1;FUT	henɁ¹³	henɁ¹
hǿɁ¹²	V;IRR;PL;1;FUT	høɁ¹³	høɁ¹³
chi²+dsán²	V;IRR;PL;1;FUT	chi¹+dsan¹³	chi¹+dsa
guieɁ¹²	V;IRR;PL;1;FUT	guieɁ³	guieɁ³³
mi²+chian¹²	V;IRR;PL;1;FUT	mi¹+chian³	mi¹+chian
guiúg²	V;IRR;PL;1;FUT	guiug¹³	guiug¹
Ɂon¹²	V;IRR;PL;1;FUT	Ɂeng³	Ɂon¹³
niá¹²	V;IRR;PL;1;FUT	nia¹	nia³³
tangɁ²	V;IRR;PL;1;FUT	tiangɁ³	tingɁ³
Ɂan¹²	V;IRR;PL;1;FUT	Ɂan¹³	Ɂan¹³
dsian¹²	V;IRR;PL;1;FUT	dsian¹³	dsian¹³
dság¹²	V;IRR;PL;1;FUT	nei³	dsig³Ɂ
chi²+dsí²	V;IRR;PL;1;FUT	chi¹+dsi³	chi¹+dsi
tsanɁ¹²	V;IRR;PL;1;FUT	huanɁ³	tsanɁ¹³
tánɁ¹²	V;IRR;PL;1;FUT	tanɁ¹³	tanɁ¹³
gógɁ¹²	V;IRR;PL;1;FUT	gogɁ¹	gogɁ¹³
ɁuáiɁ¹²	V;IRR;PL;1;FUT	ɁuaiɁ¹³	ɁuaiɁ³³
mi²+hénɁ²	V;IRR;PL;1;FUT	mi¹+henɁ³	mi¹+henɁ
ti²+líɁ¹	V;IRR;PL;1;FUT	ti¹+liɁ¹	ti¹+liɁ
ɁúgɁ²	V;IRR;PL;1;FUT	ɁogɁ³	ɁugɁ¹
tieɁ¹²	V;IRR;PL;1;FUT	tieɁ³	tieɁ¹³
chio¹²	V;IRR;PL;1;FUT	chieg³	chio¹³
hinɁ³	V;IRR;PL;1;FUT	hinɁ¹	hinɁ¹
tian¹²	V;IRR;PL;1;FUT	tian¹	tian¹³
ngē¹²	V;IRR;PL;1;FUT	ngē¹³	ngē¹³
lanɁ¹²	V;IRR;PL;1;FUT	lanɁ¹	linɁ¹³
ngái¹²	V;IRR;PL;1;FUT	ngai³	ngai³Ɂ
tión²	V;IRR;PL;1;FUT	tion³	tion¹
tsø²+kuenɁ¹²	V;IRR;PL;1;FUT	tsø¹+kuenɁ¹²	tsø¹+kuenɁ
hngiáɁ²	V;IRR;PL;1;FUT	hngiaɁ¹³	hngiaɁ¹
ngioɁ¹²	V;IRR;PL;1;FUT	ngioɁ³	ngioɁ³¹
ngøa¹²	V;IRR;PL;1;FUT	ngøa³	ngøa³³
ɁlianɁ²	V;IRR;PL;1;FUT	ɁlianɁ¹	ɁlianɁ¹
hngióɁ¹²	V;IRR;PL;1;FUT	hngioɁ¹³	hngioɁ¹
se¹²	V;IRR;PL;1;FUT	se¹³	se¹³³
tsǿɁ¹²	V;IRR;PL;1;FUT	tsøɁ¹³	tsøɁ¹³
guiú²	V;IRR;PL;1;FUT	guiu¹³	guiu¹
ta¹²	V;IRR;PL;1;FUT	ta³	ta¹³³
rónɁ¹²	V;IRR;PL;1;FUT	ronɁ¹	ronɁ¹³
ha²+Ɂan³	V;IRR;PL;1;FUT	ha¹+Ɂan³	ha¹+Ɂan
kúgɁ¹²	V;IRR;PL;1;FUT	kiugɁ¹³	kugɁ³¹
nioɁ²	V;IRR;PL;1;FUT	nioɁ¹	nioɁ¹
huúɁ¹²	V;IRR;PL;1;FUT	huuɁ³	huuɁ³¹
kágɁ¹²	V;IRR;PL;1;FUT	kagɁ³	kagɁ³³
hḗnɁ²	V;IRR;PL;1;FUT	hēnɁ¹³	hēnɁ¹
mi²+hnia¹²	V;IRR;PL;1;FUT	mi¹+hnia¹³	mi¹+hnia
chi²+kián²	V;IRR;PL;1;FUT	chi¹+kian³	chi¹+kia
hian¹²	V;IRR;PL;1;FUT	hian¹³	hian¹³
ku² hmo¹²	V;IRR;PL;1;FUT	ku³	ku³i³¹³²
kión²	V;IRR;PL;1;FUT	kion³	kion³
téiɁ¹²	V;IRR;PL;1;FUT	teiɁ³	teiɁ¹³
ɁóɁ²	V;IRR;PL;1;FUT	ɁoɁ¹³	ɁoɁ¹¹
ngē²	V;IRR;PL;1;FUT	ngie¹	ngē¹³
mi²+dsēn¹²	V;IRR;PL;1;FUT	mi¹+dsēn¹³	mi¹+dsēn
mi²+ɁḗɁ²	V;IRR;PL;1;FUT	mi¹+ɁēɁ³	mi¹+ɁēɁ
tø²+ɁénɁ¹²	V;IRR;PL;1;FUT	tø¹+ɁenɁ¹³	tø¹+ɁenɁ
rón²	V;IRR;PL;1;FUT	ron²	ron³³
Ɂo¹²	V;IRR;PL;1;FUT	Ɂøg³	Ɂo¹¹³
hǿɁ²	V;IRR;PL;1;FUT	høɁ¹³	høɁ¹³
hnaiɁ¹²	V;IRR;PL;1;FUT	hnaiɁ³	hnaiɁ³³
tai²	V;IRR;PL;1;FUT	tei³	tai³³
ɁuǿɁ¹²	V;IRR;PL;1;FUT	ɁuøɁ¹³	ɁuøɁ¹³
kán²	V;IRR;PL;1;FUT	kiin³	kan¹³
háinɁ¹²	V;IRR;PL;1;FUT	hainɁ³	hainɁ³³
dsø²+huen¹³	V;IRR;PL;1;FUT	dsø¹+huen¹³	dsø¹+huen
lag²	V;IRR;PL;1;FUT	lag³	lag³Ɂ
mi²+Ɂnio¹	V;IRR;PL;1;FUT	mi¹+Ɂnio¹	mi¹+Ɂnio
bán²	V;IRR;PL;1;FUT	ban¹³	ban¹³
kiuɁ¹²	V;IRR;PL;1;FUT	kiuɁ³	kiuɁ³³
guøn¹²	V;IRR;PL;1;FUT	guøn²	guøn²³
mi²+gug¹	V;IRR;PL;1;FUT	mi¹+gug¹	mi¹+gug
len¹²	V;IRR;PL;1;FUT	len¹³	len³¹
rǿnɁ¹²	V;IRR;PL;1;FUT	rønɁ³	rønɁ³³
gog²	V;IRR;PL;1;FUT	gog³	gog³Ɂ
lán¹²	V;IRR;PL;1;FUT	len²	lan¹³
niá²	V;IRR;PL;1;FUT	nia³	nia³³
Ɂno¹²	V;IRR;PL;1;FUT	Ɂneng³	Ɂno¹¹
chióɁ¹²	V;IRR;PL;1;FUT	chioɁ³	chioɁ¹³
siúg²	V;IRR;PL;1;FUT	siog³	siog³
dsiag¹²	V;IRR;PL;1;FUT	dsiag³	dsiag³³
teng¹²	V;IRR;PL;1;FUT	teng³	teng¹³
ngié²	V;IRR;PL;1;FUT	ngie²	ngie²
tsogɁ² hmøi²	V;IRR;PL;1;FUT	tsogɁ¹	tsogɁ¹²³Ɂ¹
ɁnáiɁ¹²	V;IRR;PL;1;FUT	ɁnaiɁ³	ɁnaiɁ³³
hnio³	V;IRR;PL;1;FUT	hnio¹	hnio¹
Ɂngio¹²	V;IRR;PL;1;FUT	Ɂngio¹³	Ɂngio¹³
ténɁ¹²	V;IRR;PL;1;FUT	tenɁ¹³	tenɁ¹³
guǿn¹²	V;IRR;PL;1;FUT	guøn¹³	guøn¹³
tán¹²	V;IRR;PL;1;FUT	tig¹³	tan¹³
tson²	V;IRR;PL;1;FUT	chion¹	tson¹
Ɂio¹²	V;IRR;PL;1;FUT	Ɂieg³	Ɂio¹¹
hen¹²	V;IRR;PL;1;FUT	hen¹	hen³³
hián²	V;IRR;PL;1;FUT	hian²	hian¹
huǿin¹²	V;IRR;PL;1;FUT	huøin³	huøin³³
tsón¹²	V;IRR;PL;1;FUT	tson¹	tson³¹
kii²+túg²	V;IRR;PL;1;FUT	kii¹+tog³	kii¹+tog
kii²+tág¹²	V;IRR;PL;1;FUT	kii¹+tag³	kii¹+tag
hngia¹²	V;IRR;PL;1;FUT	hngia¹³	hngia¹³
dsoɁ²	V;IRR;PL;1;FUT	dsioɁ¹	dsoɁ¹
Ɂán²	V;IRR;PL;1;FUT	Ɂan¹³	Ɂan¹³
køn¹²	V;IRR;PL;1;FUT	køn³	køn¹³
Ɂiog²	V;IRR;PL;1;FUT	Ɂiog¹	Ɂiog¹
tsog²	V;IRR;PL;1;FUT	tsog¹	tsog¹
mi²+tsḗn¹	V;IRR;PL;1;FUT	mi¹+tsēn¹³	mi¹+tsēn
kugɁ¹²	V;IRR;PL;1;FUT	kugɁ¹³	kugɁ¹³
tsǿaɁ¹²	V;IRR;PL;1;FUT	tsenɁ¹³	tsøaɁ³³
hne¹²	V;IRR;PL;1;FUT	hngiu³	hne³u
ɁioɁ¹²	V;IRR;PL;1;FUT	ɁioɁ¹³	ɁioɁ¹³
ku²+hmáɁ²	V;IRR;PL;1;FUT	ku¹+hmaɁ¹³	ku¹+hmaɁ
hág¹²	V;IRR;PL;1;FUT	hag¹³	hag¹³
hmóɁ¹²	V;IRR;PL;1;FUT	hmoɁ³	hmoɁ³³
hngie¹²	V;IRR;PL;1;FUT	hngie³	hngie³n
mi²+dsiog¹	V;IRR;PL;1;FUT	mi¹+dsiog¹	mi¹+dsio
Ɂnia¹²	V;IRR;PL;1;FUT	Ɂnia¹³	Ɂnia¹³
héin¹²	V;IRR;PL;1;FUT	hein³	hein¹³
dsiánɁ¹²	V;IRR;PL;1;FUT	dsianɁ¹³	dsianɁ¹
kieg²	V;IRR;PL;1;FUT	kieg¹³	kieg¹
mi²+tan¹²	V;IRR;PL;1;FUT	mi¹+tan³	mi¹+tan³
køin²	V;IRR;PL;1;FUT	kiing³	køin¹
chiáng¹²	V;IRR;PL;1;FUT	chiang³	chiang³
møa¹²	V;IRR;PL;1;FUT	møa³	møa³¹
gǿaɁ¹²	V;IRR;PL;1;FUT	kie¹³	gøaɁ³¹
guen²	V;IRR;PL;1;FUT	guøi¹	guen¹
tug	V;IRR;PL;1;FUT	tiug¹²	tiug
hngēɁ¹²	V;IRR;PL;1;FUT	hngēɁ¹³	hngēɁ¹³
hmǿɁ¹²	V;IRR;PL;1;FUT	hmøɁ³	hmøɁ³³
tsénɁ²	V;IRR;PL;1;FUT	tsenɁ³	tsenɁɁ
chiunɁ¹²	V;IRR;PL;1;FUT	chiunɁ³	chiunɁ³
Ɂméi¹²	V;IRR;PL;1;FUT	Ɂmei³	Ɂmei³³
tø²+húg³	V;IRR;PL;1;FUT	tø¹+hug³	tø¹+hug
kug²	V;IRR;PL;1;FUT	kug¹	kug¹³
tsēn¹²	V;IRR;PL;1;FUT	tsig³	tsin¹³
mi²+Ɂlí¹	V;IRR;PL;1;FUT	mi¹+Ɂli³	mi¹+Ɂli
chiogɁ¹²	V;IRR;PL;1;FUT	chiogɁ¹	chiogɁ¹
chi²+méɁ²	V;IRR;PL;1;FUT	chi¹+meɁ¹³	chi¹+meɁ
chi²+lánɁ²	V;IRR;PL;1;FUT	chi¹+lanɁ¹³	chi¹+lan
Ɂén²	V;IRR;PL;1;FUT	Ɂen¹³	Ɂen¹³
hánɁ²	V;IRR;PL;1;FUT	hanɁ¹³	hanɁ¹
uǿi²	V;IRR;PL;1;FUT	uøi¹³	uøi¹³
mi²+kuuɁ¹²	V;IRR;PL;1;FUT	mi¹+kuuɁ¹³	mi¹+kuuɁ
mi²+hlíɁ²	V;IRR;PL;1;FUT	mi¹+hliɁ³	mi¹+hliɁ
mi²+níɁ¹	V;IRR;PL;1;FUT	mi¹+niɁ³	mi¹+niɁ
búɁ²	V;IRR;PL;1;FUT	buɁ¹³	buɁ¹³
Ɂiei¹²	V;IRR;PL;1;FUT	Ɂiei³	Ɂiei¹³
hngiángɁ¹²	V;IRR;PL;1;FUT	hngiangɁ³	hngiangɁ
tsø²+han¹²	V;IRR;PL;1;FUT	tsø¹+han¹	tsø¹+han
kién¹²	V;IRR;PL;1;FUT	kien¹³	kien³³
hḗn²	V;IRR;PL;1;FUT	hēn¹³	hēn¹³
ngai¹²	V;IRR;PL;1;FUT	ngai³	ngai³³
mi²+hngió¹	V;IRR;PL;1;FUT	mi¹+hngio¹³	mi¹+hngi
chión²	V;IRR;PL;1;FUT	chion³	chion¹
hmḗɁ²	V;IRR;PL;1;FUT	hmēɁ³	hmēɁ³
Ɂiog¹²	V;IRR;PL;1;FUT	Ɂiog¹³	Ɂiog¹³
dsø²+togɁ¹²	V;IRR;PL;1;FUT	dsø¹+togɁ¹	dsø¹+togɁ
mi²+dsíg²	V;IRR;PL;1;FUT	mi¹+dsig³	mi¹+dsig
tǿɁ²	V;IRR;PL;1;FUT	te¹³	tøɁ¹³
hnáɁ²	V;IRR;PL;1;FUT	hnaɁ³	hnaɁ¹
ngøɁ¹²	V;IRR;PL;1;FUT	ngøɁ³	ngøɁ³³
huúɁ²	V;IRR;PL;1;FUT	huuɁ³	huuɁ³
ɁiéiɁ¹²	V;IRR;PL;1;FUT	ɁieiɁ³	ɁieiɁ³³
chiag¹²	V;IRR;PL;1;FUT	chiag³	chiag³³
káiɁ¹²	V;IRR;PL;1;FUT	kieiɁ¹³	kaiɁ³³
chi²+hné¹	V;IRR;PL;1;FUT	chi¹+hne³	chi¹+hne
hmáɁ² (dsǿa¹²)	V;IRR;PL;1;FUT	hmaɁ¹³	hmaɁ¹³²³¹³g
tónɁ² (huu¹²)	V;IRR;PL;1;FUT	tiunɁ¹³	tiunɁ¹³³³¹
tanɁ²	V;IRR;PL;1;FUT	tianɁ¹	tanɁ¹
hogɁ¹²	V;IRR;PL;1;FUT	hogɁ¹²	hogɁ¹³
Ɂuan¹²	V;IRR;PL;1;FUT	Ɂuan¹³	Ɂuan¹³
kēnɁ¹²	V;IRR;PL;1;FUT	kienɁ¹³	kinnɁ¹
dsióɁ¹²	V;IRR;PL;1;FUT	dsioɁ¹³	dsioɁ¹³
tsiɁ¹²	V;IRR;PL;1;FUT	tsiɁ³	tsiɁ³¹
tsánɁ²	V;IRR;PL;1;FUT	chianɁ¹³	tsanɁ¹
hlái²	V;IRR;PL;1;FUT	hlai¹³	hlai³
ɁnióɁ¹²	V;IRR;PL;1;FUT	ɁnioɁ¹³	ɁnioɁ³³
ngiú²	V;IRR;PL;1;FUT	ngiu³	ngiu³
lúg²	V;IRR;PL;1;FUT	liug²	lug²²
tag¹²	V;IRR;PL;1;FUT	teg³	tag³³
ɁiánɁ²	V;IRR;PL;1;FUT	ɁianɁ¹³	ɁianɁɁ
mi²+Ɂai¹	V;IRR;PL;1;FUT	mi¹+Ɂai¹	mi¹+Ɂai
kiog¹²	V;IRR;PL;1;FUT	kiog³	kiog¹³
chi²+dsén²	V;IRR;PL;1;FUT	chi¹+dsen¹³	chi¹+dse
hlán²	V;IRR;PL;1;FUT	hlan³	hlan¹
tsen¹²	V;IRR;PL;1;FUT	tsen³	tsen³¹
dsan²	V;IRR;PL;1;FUT	dsian¹	dsan¹
hliúg² (lag³ dsi³)	V;IRR;PL;1;FUT	hliug¹³	hliug¹³¹n³³(((
hmáɁ² (ta³)	V;IRR;PL;1;FUT	hmaɁ¹³	hmaɁ¹³³³Ɂ
tiun¹²	V;IRR;PL;1;FUT	teng¹³	tiun¹³
dsǿɁ²	V;IRR;PL;1;FUT	dsøɁ¹³	dsøɁ¹
ha¹²	V;IRR;PL;1;FUT	ha¹³	ha¹³³
guian¹²	V;IRR;PL;1;FUT	guian¹³	guian¹³
mi²+ngḗɁ¹	V;IRR;PL;1;FUT	mi¹+ngēɁ³	mi¹+ngēɁ
Ɂien²	V;IRR;PL;1;FUT	Ɂien¹	Ɂien¹
guiúnɁ¹²	V;IRR;PL;1;FUT	guiunɁ¹³	guiunɁ¹
mi²+kuen¹²	V;IRR;PL;1;FUT	mi¹+kuen¹³	mi¹+kuen
hliánɁ²	V;IRR;PL;1;FUT	hlianɁ¹³	hlianɁ¹
mi²+gǿg¹	V;IRR;PL;1;FUT	mi¹+gøg¹	mi¹+gøg
kanɁ¹²	V;IRR;PL;1;FUT	kanɁ¹³	kanɁ³³
chi²+ngió²	V;IRR;PL;1;FUT	chi¹+ngio³	chi¹+ngi
hnó²	V;IRR;PL;1;FUT	hno³	hno³³
ti²+dsiog¹	V;IRR;PL;1;FUT	ti¹+dsiog³	ti¹+dsio
Ɂnē¹²	V;IRR;PL;1;FUT	Ɂnē¹³	Ɂnē¹¹
hlég²	V;IRR;PL;1;FUT	hleg²	hleg¹
dsii²+lian¹	V;IRR;PL;1;FUT	dsii¹+lian¹	dsii¹+lia
hné¹²	V;IRR;PL;1;FUT	hne³	hne³³
tsón²	V;IRR;PL;1;FUT	tson³	tson³
chiog¹²	V;IRR;PL;1;FUT	chiog¹³	chiog³³
húgɁ²	V;IRR;PL;1;FUT	hogɁ¹³	hugɁ¹
mái¹²	V;IRR;PL;1;FUT	mai³	mai³³
kiáɁ²	V;IRR;PL;1;FUT	kiaɁ¹³	kiaɁ¹
mi²+rø¹²	V;IRR;PL;1;FUT	mi¹+rø³	mi¹+rø³
dsogɁ¹²	V;IRR;PL;1;FUT	dsogɁ¹³	dsogɁ¹³
hiugɁ¹²	V;IRR;PL;1;FUT	hiugɁ³	hiugɁ³³
kií¹²	V;IRR;PL;1;FUT	kii³	kii¹³
kian¹²	V;IRR;PL;1;FUT	kian³	kian¹³
mi²+hínɁ²	V;IRR;PL;1;FUT	mi¹+hinɁ³	mi¹+hinɁ
Ɂngiéng¹²	V;IRR;PL;1;FUT	Ɂngieng³	Ɂngieng³
ɁnáɁ¹²	V;IRR;PL;1;FUT	ɁniaɁ¹³	ɁnaɁ¹³
ɁliuɁ¹²	V;IRR;PL;1;FUT	ɁliuɁ³	ɁliuɁ³³
siég²	V;IRR;PL;1;FUT	sieg¹³	sieg¹
sianɁ¹²	V;IRR;PL;1;FUT	sianɁ¹³	sianɁ¹³
nió²	V;IRR;PL;1;FUT	nio¹³	nio³³
tsén²	V;IRR;PL;1;FUT	tsen³	tsen³
búɁ¹²	V;IRR;PL;1;FUT	buɁ¹	buɁ¹³
Ɂuan²	V;IRR;PL;1;FUT	Ɂuen³	Ɂuan¹
mi²+guionɁ¹	V;IRR;PL;1;FUT	mi¹+guionɁ³	mi¹+guion
tagɁ²	V;IRR;PL;1;FUT	tiagɁ³	tagɁɁ
kúgɁ²	V;IRR;PL;1;FUT	kugɁ³	kugɁɁ
Ɂma¹²	V;IRR;PL;1;FUT	Ɂma¹³	Ɂma³³
chiágɁ¹²	V;IRR;PL;1;FUT	chiagɁ³	chiagɁ³
hiégɁ¹²	V;IRR;PL;1;FUT	hiegɁ³	hiegɁ³³
ngáɁ¹²	V;IRR;PL;1;FUT	ngaɁ³	ngaɁ³¹
mi²+Ɂliúg²	V;IRR;PL;1;FUT	mi¹+Ɂliug³	mi¹+Ɂliu
mi²+dsií¹	V;IRR;PL;1;FUT	mi¹+dsii³	mi¹+dsii
tóɁ¹²	V;IRR;PL;1;FUT	tioɁ¹³	toɁ¹³
kán² guiing²	V;IRR;PL;1;FUT	kan¹³	kan¹³³³²³²
Ɂug¹²	V;IRR;PL;1;FUT	Ɂug¹³	Ɂug¹³
hái¹²	V;IRR;PL;1;FUT	hai³	hai³³
ián²	V;IRR;PL;1;FUT	ian¹³	ian³³
hén²	V;IRR;PL;1;FUT	hen²	hen¹¹
mi²+Ɂan¹²	V;IRR;PL;1;FUT	mi¹+lig2¹³	mi¹+lig2
hngieng¹²	V;IRR;PL;1;FUT	hngieng³	hngieng³
pø²+hánɁ²	V;IRR;PL;1;FUT	pø¹+hanɁ¹³	pø¹+hanɁ
lá¹²	V;IRR;PL;1;FUT	lie¹³	la¹³¹
Ɂø²+tsúgɁ²	V;IRR;PL;1;FUT	Ɂø¹+tsogɁ²	Ɂø¹+tsog
ɁaiɁ²	V;IRR;PL;1;FUT	ɁeiɁ³	ɁaiɁ³
Ɂéi¹²	V;IRR;PL;1;FUT	Ɂei¹³	Ɂei¹³
hønɁ¹²	V;IRR;PL;1;FUT	hinɁ¹³	hinɁ¹³
gúg²	V;IRR;PL;1;FUT	gog³	gog³³
Ɂuǿi²	V;IRR;PL;1;FUT	Ɂuai¹³	Ɂuøi¹
tiánɁ¹²	V;IRR;PL;1;FUT	tianɁ¹³	tianɁ¹³
hnióɁ²	V;IRR;PL;1;FUT	hnioɁ²	hnioɁ²
tsenɁ¹²	V;IRR;PL;1;FUT	tsenɁ¹³	tsenɁ¹³
guieng¹²	V;IRR;PL;1;FUT	guieng³	guieng³
nang¹²	V;IRR;PL;1;FUT	neng³	nang³³
kuénɁ²	V;IRR;PL;1;FUT	kuenɁ³	kuenɁ³
chiángɁ¹²	V;IRR;PL;1;FUT	chiangɁ³	chiangɁ³
mē¹²	V;IRR;PL;1;FUT	mē¹³	mē¹³Ɂ
kiagɁ¹²	V;IRR;PL;1;FUT	kiagɁ³	kiagɁ³³
hniang²	V;IRR;PL;1;FUT	hniang¹	hniang³
mi²+kán¹²	V;IRR;PL;1;FUT	mi¹+kan³	mi¹+kan³
ɁmēɁ¹²	V;IRR;PL;1;FUT	ɁmēɁ¹³	ɁmēɁ³³
nié¹²	V;IRR;PL;1;FUT	nie³	nie³³
ɁenɁ¹²	V;IRR;PL;1;FUT	ɁenɁ¹³	ɁenɁ¹³
tsēnɁ¹²	V;IRR;PL;1;FUT	tsenɁ¹²	tsinɁ¹²
ɁøɁ¹²	V;IRR;PL;1;FUT	ɁiɁ¹³	ɁøɁ³¹
mḗɁ²	V;IRR;PL;1;FUT	mēɁ³	mēɁ³¹
kang²	V;IRR;PL;1;FUT	kieng³	kang³
liúg²	V;IRR;PL;1;FUT	log³	liug³
ngǿi²	V;IRR;PL;1;FUT	ngai¹³	ngøi³
togɁ¹²	V;IRR;PL;1;FUT	tiogɁ³	togɁɁ³
hḗɁ²	V;IRR;PL;1;FUT	hēɁ²	hēɁ³³
guenɁ¹²	V;IRR;PL;1;FUT	guenɁ¹³	guenɁ¹³
hénɁ¹²	V;IRR;PL;1;FUT	henɁ¹³	henɁ¹³
Ɂen¹²	V;IRR;PL;1;FUT	Ɂen¹³	Ɂen¹³
lánɁ²	V;IRR;PL;1;FUT	lanɁ¹³	lanɁ¹
ngie³	V;IRR;PL;1;FUT	ngie³	ngie³
ngieɁ¹³	V;IRR;PL;1;FUT	ngieɁ¹³	ngieɁ¹³
lióg¹²	V;IRR;PL;1;FUT	liog¹³	liog¹³
mi²+gan¹	V;IRR;PL;1;FUT	mi¹+gan¹	mi¹+gan
kón²	V;IRR;PL;1;FUT	kon³	kon¹³
ɁéɁ²	V;IRR;PL;1;FUT	ɁeɁ³	ɁeɁ¹³
hngió²	V;IRR;PL;1;FUT	hngio¹³	hngio¹
Ɂme¹²	V;IRR;PL;1;FUT	Ɂme³	Ɂme³³
Ɂé²	V;IRR;PL;1;FUT	Ɂe²	Ɂe²³
Ɂog¹²	V;IRR;PL;1;FUT	Ɂog¹	Ɂog¹³
kø¹²	V;IRR;PL;1;FUT	kø³	kø³³g
Ɂian¹²	V;IRR;PL;1;FUT	Ɂian¹²	Ɂian¹³
bø²+lḗnɁ²	V;IRR;PL;1;FUT	bø¹+lēnɁ³	bø¹+lēnɁ
mi²+dsian¹²	V;IRR;PL;1;FUT	mi¹+dsian¹³	mi¹+dsian
kēn²	V;IRR;PL;1;FUT	kēn³	kēn³Ɂ
chiúg²	V;IRR;PL;1;FUT	chiug¹³	chiug¹
ɁánɁ²	V;IRR;PL;1;FUT	ɁanɁ¹³	ɁanɁ¹
ɁlanɁ¹²	V;IRR;PL;1;FUT	ɁlanɁ¹³	ɁlanɁ¹³
tiúg²	V;IRR;PL;1;FUT	tiug¹³	tiug³
guu²+dsḗn¹³	V;IRR;PL;1;FUT	guu¹+dsēn¹³	guu¹+dsēn
guiánɁ¹²	V;IRR;PL;1;FUT	guianɁ¹³	guianɁ¹
hniá¹²	V;IRR;PL;1;FUT	hnia¹	hnia¹³
hlíɁ¹²	V;IRR;PL;1;FUT	hliɁ³	hliɁ¹³
séi²	V;IRR;PL;1;FUT	sei¹³	sei¹³
ɁlieɁ¹²	V;IRR;PL;1;FUT	ɁlieɁ³	ɁlieɁ³³
huen¹²	V;IRR;PL;1;FUT	huen¹³	huen¹³
ieg¹²	V;IRR;PL;1;FUT	ieg³	ieg³³
hog¹²	V;IRR;PL;1;FUT	hog¹	hog¹³
køgɁ²	V;IRR;PL;1;FUT	køgɁ¹³	køgɁ¹
chiúgɁ²	V;IRR;PL;1;FUT	chiugɁ³	chiugɁ³
lan²	V;IRR;PL;1;FUT	lian¹³	lan³¹
ɁénɁ¹²	V;IRR;PL;1;FUT	ɁenɁ¹³	ɁenɁ¹³
tsá¹²	V;IRR;PL;1;FUT	tsa³	tsa³³
huu¹²	V;IRR;PL;1;FUT	huu³	huu³g
tsíɁ¹²	V;IRR;PL;1;FUT	tsiɁ¹	tsiɁ³¹
Ɂéng²	V;IRR;PL;1;FUT	Ɂeng¹³	Ɂeng¹
tan¹³	V;IRR;PL;1;FUT	tan¹³	tan¹³
ɁiíɁ²	V;IRR;PL;1;FUT	ɁiiɁ¹³	ɁiiɁ¹
hnóɁ²	V;IRR;PL;1;FUT	hnoɁ¹³	hnoɁ¹
ɁlíɁ¹²	V;IRR;PL;1;FUT	ɁliɁ¹³	ɁliɁ³³
hnéi¹²	V;IRR;PL;1;FUT	hnei³	hnei¹³
koɁ¹²	V;IRR;PL;1;FUT	koɁ¹³	koɁ¹³
Ɂán¹² ɁogɁ¹²	V;IRR;PL;1;FUT	Ɂan¹³	Ɂan¹³¹³³³³
gúɁ¹²	V;IRR;PL;1;FUT	guɁ³	guɁ³³
kionɁ¹²	V;IRR;PL;1;FUT	kionɁ¹³	kionɁ¹³
dsi²	V;IRR;PL;1;FUT	dsi³	dsi³³
mi²+dsiagɁ¹	V;IRR;PL;1;FUT	mi¹+dsiagɁ³	mi¹+dsiag
mi²+ti¹	V;IRR;PL;1;FUT	mi¹+ti³	mi¹+ti³
chionɁ¹²	V;IRR;PL;1;FUT	chionɁ¹³	chionɁ¹
tógɁ¹²	V;IRR;PL;1;FUT	tiagɁ³	tigɁɁ³
mi²+liág¹	V;IRR;PL;1;FUT	mi¹+liag¹³	mi¹+liag
guuɁ¹²	V;IRR;PL;1;FUT	kieng¹³	guuɁ¹¹
dsanɁ¹²	V;IRR;PL;1;FUT	dsianɁ¹²	dsanɁ¹³
téiɁ²	V;IRR;PL;1;FUT	teiɁ¹³	teiɁ¹
neɁ¹²	V;IRR;PL;1;FUT	neɁ³	neɁ³³
mi²+gag¹²	V;IRR;PL;1;FUT	mi¹+gag¹³	mi¹+gag¹
høn¹²	V;IRR;PL;1;FUT	hin³	høn¹¹
hógɁ¹²	V;IRR;PL;1;FUT	hiugɁ¹³	hogɁ¹³
kieng¹²	V;IRR;PL;1;FUT	kieng³	kieng³³
mi²+dsē¹²	V;IRR;PL;1;FUT	mi¹+dsē¹³	mi¹+dsē¹
nǿɁ²	V;IRR;PL;1;FUT	nøɁ¹³	nøɁ¹³
hngiú²	V;IRR;PL;1;FUT	hngiu¹³	hngiu¹
tei²	V;IRR;PL;1;FUT	tei³	tei³³
kuø¹²	V;IRR;PL;1;FUT	kuø³	kuø³³
kián²	V;IRR;PL;1;FUT	kian¹³	kian¹
hiúɁ²	V;IRR;PL;1;FUT	hioɁ³	hiuɁ³
dsén²	V;IRR;PL;1;FUT	dsen¹³	dsen¹
ɁiuɁ³ (ɁéɁ¹)	V;IRR;PL;1;FUT	ɁiuɁ³	ɁiuɁ³³³2³¹
ɁiúɁ¹²	V;IRR;PL;1;FUT	ɁiuɁ³	ɁiuɁ³³
hǿa¹²	V;IRR;PL;1;FUT	høa³	høa¹³
kiiɁ²	V;IRR;PL;1;FUT	kiiɁ³	kiiɁ¹
hlǿ²	V;IRR;PL;1;FUT	hlø¹³	hlø¹¹
tan¹²	V;IRR;PL;1;FUT	tan¹	tan¹³
Ɂøin¹²	V;IRR;PL;1;FUT	Ɂøin¹³	Ɂøin¹³
Ɂen¹³	V;IRR;PL;1;FUT	Ɂen¹³	Ɂen¹³
tanɁ¹²	V;IRR;PL;1;FUT	tianɁ¹³	tanɁ¹³
hlian¹²	V;IRR;PL;1;FUT	hlian¹	hlian¹¹
tion¹²	V;IRR;PL;1;FUT	tion¹³	tion¹³
chiógɁ² ( hmøi²)	V;IRR;PL;1;FUT	chiogɁ³	chiogɁ³³Ɂ¹³¹
Ɂø²+tsóɁ¹²	V;IRR;PL;1;FUT	Ɂø¹+tsoɁ³	Ɂø¹+tsoɁ
nøɁ¹²	V;IRR;PL;1;FUT	nøɁ³	nøɁ³³
mi²+hngiáng¹	V;IRR;PL;1;FUT	mi¹+hngiang¹³	mi¹+hngian
húg²	V;IRR;PL;1;FUT	hug²	hug³³
ɁlogɁ²	V;IRR;PL;1;FUT	ɁlogɁ¹	ɁlogɁ¹
mi²+ɁmaɁ¹³	V;IRR;PL;1;FUT	mi¹+ɁmaɁ¹³	mi¹+ɁmaɁ
siág¹²	V;IRR;PL;1;FUT	siog³	siag³¹
dsiog¹²	V;IRR;PL;1;FUT	dsiog³	dsiog³¹
kienɁ¹²	V;IRR;PL;1;FUT	kienɁ¹³	kienɁ¹³
ɁløaɁ¹²	V;IRR;PL;1;FUT	ɁløaɁ³	ɁløaɁ³³
Ɂiá¹²	V;IRR;PL;1;FUT	Ɂia¹³	Ɂia¹³
chiínɁ²	V;IRR;PL;1;FUT	chienɁ¹³	chienɁ¹
dsúgɁ¹²	V;IRR;PL;1;FUT	dsugɁ¹	dsugɁ¹³
héi²	V;IRR;PL;1;FUT	hi¹³	hei³³
mi²+dsiúg²	V;IRR;PL;1;FUT	mi¹+dsiug³	mi¹+dsiu
hnia¹²	V;IRR;PL;1;FUT	hnia¹	hnia¹³
hnḗ¹²	V;IRR;PL;1;FUT	hnē¹	hnē¹³
ɁóɁ¹²	V;IRR;PL;1;FUT	ɁoɁ¹³	ɁoɁ¹³
mi²+tián² (dsǿa¹²)	V;IRR;PL;1;FUT	mi¹+tian³	mi¹+tian³³³¹³(
u²+nio¹³	V;IRR;PL;1;FUT	u¹+nio¹³	u¹+nio¹
dsiánɁ²	V;IRR;PL;1;FUT	dsianɁ³	dsianɁ¹
tsø²+nióɁ²	V;IRR;PL;1;FUT	tsø¹+nioɁ³	tsø¹+nio
kuú²	V;IRR;PL;1;FUT	kuu³	kuu³³
bá²	V;IRR;PL;1;FUT	ba¹³	ba¹³
kon¹²	V;IRR;PL;1;FUT	kon¹	kon¹³
mi²+hlēnɁ¹	V;IRR;PL;1;FUT	mi¹+hlēnɁ³	mi¹+hlēn
hmo¹²	V;IRR;PL;1;FUT	hmo³	hmo³³
nei¹²	V;IRR;PL;1;FUT	nei³	nei³³
tei¹²	V;IRR;PL;1;FUT	tei³	tei³³
mi²+hniang¹ dsǿa¹²	V;IRR;PL;1;FUT	mi¹+hniang³	mi¹+hniang³¹³(
huánɁ¹²	V;IRR;PL;1;FUT	huanɁ¹²	huanɁ¹³
rang¹²	V;IRR;PL;1;FUT	rang³	rang³³
hínɁ¹²	V;IRR;PL;1;FUT	hinɁ³	hinɁ³²
ɁmíɁ²	V;IRR;PL;1;FUT	ɁmiɁ³	ɁmiɁ³
hiég²	V;IRR;PL;1;FUT	hieg¹³	hieg¹
kánɁ²	V;IRR;PL;1;FUT	kanɁ¹³	kanɁ¹
mi²+ténɁ²	V;IRR;PL;1;FUT	mi¹+tenɁ³	mi¹+tenɁ
nung²	V;IRR;PL;1;FUT	nung³	nung¹
iaɁ¹²	V;IRR;PL;1;FUT	iaɁ³	iaɁ³³
u²+Ɂai¹²	V;IRR;PL;1;FUT	u¹+Ɂai¹	u¹+Ɂai¹
ngo²	V;IRR;PL;1;FUT	ngo¹	ngo¹³
chi²+ngiú²	V;IRR;PL;1;FUT	chi¹+ngiu³	chi¹+ngi
